Year,Country of Origin,Country ISO,Refugees Current Year,Refugees Last Year,Change in Refugees
2022,Ukraine,UKR,5592299,23301,5568998
2015,Syrian Arab Rep.,SYR,2782053,1696978,1085075
2014,Syrian Arab Rep.,SYR,1696978,652592,1044386
2017,Syrian Arab Rep.,SYR,4240430,3478683,761747
2016,Syrian Arab Rep.,SYR,3478683,2782053,696630
2013,Syrian Arab Rep.,SYR,652592,284240,368352
2018,Syrian Arab Rep.,SYR,4511172,4240430,270742
2012,Syrian Arab Rep.,SYR,284240,18064,266176
2014,Ukraine,UKR,234591,2097,232494
2021,Syrian Arab Rep.,SYR,4807122,4656894,150228
2020,Syrian Arab Rep.,SYR,4656894,4531488,125406
2015,Ukraine,UKR,318338,234591,83747
2017,Afghanistan,AFG,245444,166534,78910
2022,Afghanistan,AFG,443944,386135,57809
2016,Iraq,IRQ,203823,151495,52328
2021,Afghanistan,AFG,386135,337095,49040
2017,Iraq,IRQ,249585,203823,45762
2018,Afghanistan,AFG,289836,245444,44392
2016,Afghanistan,AFG,166534,124408,42126
2020,Venezuela (Bolivarian Republic of),VEN,80368,38766,41602
2019,Venezuela (Bolivarian Republic of),VEN,38766,1257,37509
2016,Eritrea,ERI,144773,108849,35924
2019,Afghanistan,AFG,320122,289836,30286
2015,Eritrea,ERI,108849,81135,27714
2017,Eritrea,ERI,171274,144773,26501
2022,Venezuela (Bolivarian Republic of),VEN,117824,95248,22576
2017,Iran (Islamic Rep. of),IRN,93873,71494,22379
2019,Syrian Arab Rep.,SYR,4531488,4511172,20316
2015,Iraq,IRQ,151495,131223,20272
2015,Unknown,UNK,115511,95292,20219
2017,Unknown,UNK,149337,130717,18620
2020,Afghanistan,AFG,337095,320122,16973
2014,Eritrea,ERI,81135,65256,15879
2021,Russian Federation,RUS,60422,44785,15637
2016,Unknown,UNK,130717,115511,15206
2021,Venezuela (Bolivarian Republic of),VEN,95248,80368,14880
2019,Unknown,UNK,171966,157383,14583
2014,Afghanistan,AFG,112683,98169,14514
2021,Dem. Rep. of the Congo,COD,41867,28409,13458
2021,Iraq,IRQ,250968,238159,12809
2016,Stateless,XXA,45776,33338,12438
2015,Afghanistan,AFG,124408,112683,11725
2017,Somalia,SOM,110568,99311,11257
2021,Türkiye,TUR,78415,67221,11194
2019,Türkiye,TUR,58127,46936,11191
2022,Russian Federation,RUS,71284,60422,10862
2018,Eritrea,ERI,181901,171274,10627
2018,Iraq,IRQ,260085,249585,10500
2022,Unknown,UNK,90395,80460,9935
2015,Stateless,XXA,33338,23685,9653
2016,Iran (Islamic Rep. of),IRN,71494,62000,9494
2019,Eritrea,ERI,191224,181901,9323
2021,Sri Lanka,LKA,49565,40312,9253
2020,Türkiye,TUR,67221,58127,9094
2013,Eritrea,ERI,65256,56243,9013
2018,Iran (Islamic Rep. of),IRN,102120,93873,8247
2018,Unknown,UNK,157383,149337,8046
2014,Stateless,XXA,23685,15784,7901
2021,Guinea,GIN,31727,24112,7615
2018,Nigeria,NGA,36552,29112,7440
2017,Nigeria,NGA,29112,21727,7385
2022,Nigeria,NGA,49722,42421,7301
2011,Eritrea,ERI,51208,43998,7210
2014,Unknown,UNK,95292,88085,7207
2021,Iran (Islamic Rep. of),IRN,111461,104465,6996
2022,Belarus,BLR,10066,3080,6986
2020,Iraq,IRQ,238159,231297,6862
2021,Eritrea,ERI,198740,192114,6626
2017,Sudan,SDN,28922,22621,6301
2016,Pakistan,PAK,29551,23863,5688
2019,Sudan,SDN,39444,33764,5680
2016,Nigeria,NGA,21727,16194,5533
2019,Nigeria,NGA,42024,36552,5472
2016,Somalia,SOM,99311,93937,5374
2021,Nigeria,NGA,42421,37056,5365
2018,Türkiye,TUR,46936,41760,5176
2022,Morocco,MAR,10142,5014,5128
2015,Iran (Islamic Rep. of),IRN,62000,56897,5103
2012,Eritrea,ERI,56243,51208,5035
2017,Pakistan,PAK,34551,29551,5000
2015,Pakistan,PAK,23863,18890,4973
2018,Pakistan,PAK,39523,34551,4972
2014,Iraq,IRQ,131223,126274,4949
2016,Sudan,SDN,22621,17759,4862
2018,Sudan,SDN,33764,28922,4842
2021,Mali,MLI,21230,16718,4512
2022,Mali,MLI,25728,21230,4498
2014,Pakistan,PAK,18890,14414,4476
2020,Palestinian,PSE,15924,11452,4472
2021,Albania,ALB,17757,13403,4354
2015,Nigeria,NGA,16194,12037,4157
2013,Somalia,SOM,96154,92107,4047
2021,Sudan,SDN,45506,41479,4027
2020,Iran (Islamic Rep. of),IRN,104465,100439,4026
2017,Stateless,XXA,49788,45776,4012
2021,Cote d'Ivoire,CIV,17251,13293,3958
2018,Bangladesh,BGD,17364,13618,3746
2022,Georgia,GEO,12540,8839,3701
2021,Palestinian,PSE,19516,15924,3592
2022,Palestinian,PSE,23028,19516,3512
2015,Sudan,SDN,17759,14260,3499
2019,Guinea,GIN,24007,20519,3488
2021,Pakistan,PAK,41523,38078,3445
2011,Iran (Islamic Rep. of),IRN,52377,49026,3351
2018,Guinea,GIN,20519,17203,3316
2014,Iran (Islamic Rep. of),IRN,56897,53591,3306
2015,Gambia,GMB,6930,3719,3211
2016,Mali,MLI,15859,12658,3201
2022,Yemen,YEM,15331,12147,3184
2022,Azerbaijan,AZE,13368,10286,3082
2016,Gambia,GMB,9965,6930,3035
2021,Bangladesh,BGD,17555,14559,2996
2011,Somalia,SOM,89826,86845,2981
2019,Pakistan,PAK,42483,39523,2960
2015,Mali,MLI,12658,9698,2960
2017,Gambia,GMB,12905,9965,2940
2017,Guinea,GIN,17203,14275,2928
2014,Nigeria,NGA,12037,9149,2888
2021,Angola,AGO,8798,5918,2880
2022,Rep. of Moldova,MDA,3549,801,2748
2018,Gambia,GMB,15579,12905,2674
2021,Stateless,XXA,52133,49488,2645
2017,Bangladesh,BGD,13618,10996,2622
2019,El Salvador,SLV,4601,1980,2621
2021,Bosnia and Herzegovina,BIH,18074,15461,2613
2021,Haiti,HTI,6733,4180,2553
2022,Viet Nam,VNM,15349,12819,2530
2012,Iran (Islamic Rep. of),IRN,54883,52377,2506
2016,Bangladesh,BGD,10996,8503,2493
2022,Cote d'Ivoire,CIV,19717,17251,2466
2022,Armenia,ARM,13286,10855,2431
2022,Romania,ROU,2819,430,2389
2014,China,CHN,13322,10934,2388
2012,Mali,MLI,5668,3339,2329
2021,Georgia,GEO,8839,6511,2328
2014,Mali,MLI,9698,7409,2289
2018,Mali,MLI,20386,18099,2287
2012,Somalia,SOM,92107,89826,2281
2018,Libya,LBY,10890,8648,2242
2017,Mali,MLI,18099,15859,2240
2017,Ethiopia,ETH,15525,13298,2227
2020,Stateless,XXA,49488,47318,2170
2017,Türkiye,TUR,41760,39634,2126
2019,Cote d'Ivoire,CIV,15303,13231,2072
2015,Guinea,GIN,13135,11078,2057
2015,Sri Lanka,LKA,41145,39100,2045
2020,Sudan,SDN,41479,39444,2035
2020,Yemen,YEM,10658,8628,2030
2019,Yemen,YEM,8628,6626,2002
2021,Armenia,ARM,10855,8857,1998
2021,Mauritania,MRT,8608,6633,1975
2021,Colombia,COL,4861,2898,1963
2016,Senegal,SEN,6461,4526,1935
2017,Libya,LBY,8648,6726,1922
2018,Yemen,YEM,6626,4751,1875
2021,Ethiopia,ETH,19877,18015,1862
2019,Libya,LBY,12697,10890,1807
2022,Algeria,DZA,6672,4868,1804
2018,Cote d'Ivoire,CIV,13231,11430,1801
2018,Senegal,SEN,9930,8147,1783
2012,Libya,LBY,4189,2407,1782
2022,Dem. Rep. of the Congo,COD,43648,41867,1781
2016,Libya,LBY,6726,4946,1780
2021,Serbia and Kosovo: S/RES/1244 (1999),SRB,30738,28962,1776
2017,Yemen,YEM,4751,2983,1768
2021,Congo,COG,7117,5351,1766
2015,Senegal,SEN,4526,2777,1749
2013,Mali,MLI,7409,5668,1741
2019,Albania,ALB,12730,10998,1732
2022,India,IND,3436,1708,1728
2021,Azerbaijan,AZE,10286,8578,1708
2017,Senegal,SEN,8147,6461,1686
2022,Turkmenistan,TKM,2000,320,1680
2015,Libya,LBY,4946,3276,1670
2020,Dem. Rep. of the Congo,COD,28409,26762,1647
2022,Colombia,COL,6485,4861,1624
2019,Palestinian,PSE,11452,9865,1587
2014,Gambia,GMB,3719,2148,1571
2015,Bangladesh,BGD,8503,6947,1556
2022,Cameroon,CMR,10294,8742,1552
2021,Belarus,BLR,3080,1529,1551
2019,Dem. Rep. of the Congo,COD,26762,25212,1550
2021,El Salvador,SLV,6471,4940,1531
2012,Pakistan,PAK,15894,14389,1505
2016,Albania,ALB,8375,6870,1505
2021,Somalia,SOM,99743,98250,1493
2021,Yemen,YEM,12147,10658,1489
2021,Cameroon,CMR,8742,7328,1414
2018,Ethiopia,ETH,16918,15525,1393
2021,Libya,LBY,15275,13883,1392
2019,Mali,MLI,21771,20386,1385
2021,Rwanda,RWA,6035,4650,1385
2021,Central African Rep.,CAF,5484,4102,1382
2018,Dem. Rep. of the Congo,COD,25212,23831,1381
2016,Ethiopia,ETH,13298,11929,1369
2022,Albania,ALB,19119,17757,1362
2017,Egypt,EGY,6935,5595,1340
2016,Ghana,GHA,5124,3796,1328
2017,Albania,ALB,9697,8375,1322
2018,Palestinian,PSE,9865,8545,1320
2019,Bangladesh,BGD,18678,17364,1314
2017,Ghana,GHA,6431,5124,1307
2018,Albania,ALB,10998,9697,1301
2022,Bangladesh,BGD,18844,17555,1289
2022,El Salvador,SLV,7755,6471,1284
2017,Palestinian,PSE,8545,7271,1274
2016,Palestinian,PSE,7271,5997,1274
2020,China,CHN,18682,17414,1268
2011,Syrian Arab Rep.,SYR,18064,16808,1256
2012,Russian Federation,RUS,101016,99767,1249
2018,China,CHN,16249,15004,1245
2022,Sudan,SDN,46742,45506,1236
2014,Sri Lanka,LKA,39100,37879,1221
2022,Uzbekistan,UZB,2838,1620,1218
2014,Egypt,EGY,3588,2373,1215
2020,Nicaragua,NIC,1551,364,1187
2020,Libya,LBY,13883,12697,1186
2021,Burundi,BDI,4908,3733,1175
2011,Guinea,GIN,8137,6963,1174
2019,China,CHN,17414,16249,1165
2014,Guinea,GIN,11078,9913,1165
2019,Cameroon,CMR,7314,6152,1162
2021,Algeria,DZA,4868,3712,1156
2016,Guinea,GIN,14275,13135,1140
2011,China,CHN,12061,10958,1103
2015,Albania,ALB,6870,5774,1096
2022,Guinea,GIN,32823,31727,1096
2021,Chad,TCD,3500,2421,1079
2014,Senegal,SEN,2777,1701,1076
2012,Stateless,XXA,15345,14284,1061
2018,El Salvador,SLV,1980,931,1049
2016,Egypt,EGY,5595,4547,1048
2016,Sri Lanka,LKA,42180,41145,1035
2021,Senegal,SEN,8313,7279,1034
2018,Egypt,EGY,7955,6935,1020
2014,Albania,ALB,5774,4755,1019
2012,Guinea,GIN,9155,8137,1018
2019,Burundi,BDI,3093,2077,1016
2021,China,CHN,19690,18682,1008
2018,Cameroon,CMR,6152,5153,999
2017,Cote d'Ivoire,CIV,11430,10439,991
2018,Ghana,GHA,7405,6431,974
2016,Yemen,YEM,2983,2014,969
2015,Egypt,EGY,4547,3588,959
2013,Afghanistan,AFG,98169,97225,944
2011,Stateless,XXA,14284,13341,943
2021,Comoros,COM,1655,743,912
2020,Eritrea,ERI,192114,191224,890
2021,Morocco,MAR,5014,4134,880
2022,Lebanon,LBN,4504,3632,872
2011,Sudan,SDN,12386,11519,867
2014,Sudan,SDN,14260,13397,863
2012,Nigeria,NGA,9652,8790,862
2017,Morocco,MAR,2781,1930,851
2020,Colombia,COL,2898,2051,847
2014,Palestinian,PSE,5438,4604,834
2015,Ghana,GHA,3796,2975,821
2021,Honduras,HND,2354,1534,820
2021,Viet Nam,VNM,12819,12027,792
2012,China,CHN,12847,12061,786
2018,Morocco,MAR,3560,2781,779
2020,Honduras,HND,1534,766,768
2019,Morocco,MAR,4327,3560,767
2013,Guinea,GIN,9913,9155,758
2022,Ghana,GHA,5420,4665,755
2018,Venezuela (Bolivarian Republic of),VEN,1257,503,754
2016,Central African Rep.,CAF,2523,1773,750
2012,Sudan,SDN,13134,12386,748
2021,Egypt,EGY,7972,7230,742
2012,Cote d'Ivoire,CIV,8494,7767,727
2018,Stateless,XXA,50514,49788,726
2022,United States of America,USA,1009,288,721
2022,Honduras,HND,3064,2354,710
2019,Senegal,SEN,10637,9930,707
2014,Libya,LBY,3276,2572,704
2019,Ethiopia,ETH,17622,16918,704
2014,Bangladesh,BGD,6947,6257,690
2022,China,CHN,20366,19690,676
2020,Albania,ALB,13403,12730,673
2017,Dem. Rep. of the Congo,COD,23831,23158,673
2021,Peru,PER,1483,817,666
2015,Central African Rep.,CAF,1773,1111,662
2019,Egypt,EGY,8613,7955,658
2017,Azerbaijan,AZE,8247,7602,645
2020,Burundi,BDI,3733,3093,640
2015,China,CHN,13953,13322,631
2016,Cote d'Ivoire,CIV,10439,9808,631
2022,Central African Rep.,CAF,6113,5484,629
2021,Nicaragua,NIC,2171,1551,620
2022,Nicaragua,NIC,2784,2171,613
2017,Cameroon,CMR,5153,4545,608
2019,Gambia,GMB,16183,15579,604
2016,Cameroon,CMR,4545,3945,600
2012,Armenia,ARM,11510,10913,597
2022,Haiti,HTI,7325,6733,592
2015,Palestinian,PSE,5997,5438,559
2016,China,CHN,14512,13953,559
2021,Tunisia,TUN,1886,1329,557
2022,Burkina Faso,BFA,2168,1611,557
2014,Cote d'Ivoire,CIV,9290,8746,544
2018,Somalia,SOM,111104,110568,536
2022,Tajikistan,TJK,2585,2053,532
2013,Palestinian,PSE,4604,4074,530
2022,Tunisia,TUN,2415,1886,529
2012,Afghanistan,AFG,97225,96698,527
2022,Israel,ISR,748,222,526
2011,Cuba,CUB,1963,1441,522
2021,Gambia,GMB,9528,9006,522
2015,Cote d'Ivoire,CIV,9808,9290,518
2019,Central African Rep.,CAF,3867,3361,506
2021,Sierra Leone,SLE,3556,3053,503
2019,Georgia,GEO,6685,6183,502
2016,Dem. Rep. of the Congo,COD,23158,22658,500
2016,Morocco,MAR,1930,1435,495
2011,Mali,MLI,3339,2847,492
2017,China,CHN,15004,14512,492
2015,Yemen,YEM,2014,1526,488
2022,Kazakhstan,KAZ,2394,1906,488
2011,Libya,LBY,2407,1922,485
2017,Lebanon,LBN,3033,2550,483
2011,Cote d'Ivoire,CIV,7767,7292,475
2017,El Salvador,SLV,931,473,458
2016,Lebanon,LBN,2550,2095,455
2019,Honduras,HND,766,313,453
2012,Egypt,EGY,2162,1711,451
2011,Montenegro,MNE,3641,3194,447
2013,Stateless,XXA,15784,15345,439
2014,Central African Rep.,CAF,1111,672,439
2018,Central African Rep.,CAF,3361,2929,432
2022,Jordan,JOR,1770,1342,428
2014,Ethiopia,ETH,11650,11224,426
2017,Armenia,ARM,8955,8542,413
2011,Nigeria,NGA,8790,8383,407
2017,Central African Rep.,CAF,2929,2523,406
2021,Guinea-Bissau,GNB,1971,1568,403
2017,Tajikistan,TJK,1024,625,399
2022,Bulgaria,BGR,578,180,398
2021,Kazakhstan,KAZ,1906,1512,394
2020,Ethiopia,ETH,18015,17622,393
2022,Senegal,SEN,8703,8313,390
2011,Myanmar,MMR,3093,2714,379
2019,Colombia,COL,2051,1677,374
2011,Ukraine,UKR,22033,21665,368
2022,Mauritania,MRT,8976,8608,368
2021,Lebanon,LBN,3632,3268,364
2013,Czechia,CZE,654,291,363
2013,Senegal,SEN,1701,1341,360
2014,Ghana,GHA,2975,2617,358
2019,Niger,NER,1199,847,352
2022,Chad,TCD,3851,3500,351
2018,Georgia,GEO,6183,5838,345
2012,Palestinian,PSE,4074,3730,344
2014,Czechia,CZE,997,654,343
2020,El Salvador,SLV,4940,4601,339
2022,Angola,AGO,9135,8798,337
2019,Mauritania,MRT,6456,6123,333
2012,Ghana,GHA,6188,5858,330
2012,Gambia,GMB,1940,1614,326
2022,Egypt,EGY,8296,7972,324
2011,Armenia,ARM,10913,10589,324
2019,Chad,TCD,2650,2334,316
2020,Haiti,HTI,4180,3866,314
2019,Algeria,DZA,3797,3484,313
2021,Mongolia,MNG,1703,1392,311
2011,Zimbabwe,ZWE,15794,15484,310
2014,Armenia,ARM,8692,8385,307
2019,Ghana,GHA,7712,7405,307
2021,Togo,TGO,3695,3389,306
2019,Nicaragua,NIC,364,60,304
2012,Montenegro,MNE,3943,3641,302
2022,Kuwait,KWT,1741,1442,299
2022,Kyrgyzstan,KGZ,1648,1350,298
2021,South Sudan,SSD,847,554,293
2021,Burkina Faso,BFA,1611,1319,292
2012,Bangladesh,BGD,6509,6217,292
2019,Tajikistan,TJK,1594,1304,290
2018,Sierra Leone,SLE,3098,2809,289
2017,Algeria,DZA,3389,3101,288
2021,Ghana,GHA,4665,4377,288
2015,Uganda,UGA,2675,2388,287
2021,North Macedonia,MKD,1712,1430,282
2018,Armenia,ARM,9236,8955,281
2018,Tajikistan,TJK,1304,1024,280
2015,Ethiopia,ETH,11929,11650,279
2011,Senegal,SEN,1091,812,279
2019,Viet Nam,VNM,11897,11620,277
2017,Venezuela (Bolivarian Republic of),VEN,503,228,275
2021,Kuwait,KWT,1442,1171,271
2016,Uganda,UGA,2945,2675,270
2022,Peru,PER,1750,1483,267
2013,Sudan,SDN,13397,13134,263
2015,Niger,NER,724,466,258
2016,Algeria,DZA,3101,2844,257
2022,Cuba,CUB,1183,929,254
2011,Pakistan,PAK,14389,14136,253
2013,Cote d'Ivoire,CIV,8746,8494,252
2020,Tajikistan,TJK,1845,1594,251
2012,Senegal,SEN,1341,1091,250
2019,Azerbaijan,AZE,8700,8456,244
2019,Haiti,HTI,3866,3623,243
2012,Kyrgyzstan,KGZ,2646,2404,242
2018,Chad,TCD,2334,2094,240
2015,Morocco,MAR,1435,1195,240
2011,Kyrgyzstan,KGZ,2404,2166,238
2022,Comoros,COM,1890,1655,235
2020,Central African Rep.,CAF,4102,3867,235
2011,Azerbaijan,AZE,12659,12425,234
2018,Lebanon,LBN,3265,3033,232
2022,Sierra Leone,SLE,3786,3556,230
2013,Mauritania,MRT,5537,5309,228
2011,Egypt,EGY,1711,1483,228
2014,Morocco,MAR,1195,969,226
2011,Yemen,YEM,1383,1158,225
2012,Yemen,YEM,1605,1383,222
2017,Guinea-Bissau,GNB,1793,1572,221
2019,Lebanon,LBN,3486,3265,221
2011,Gambia,GMB,1614,1395,219
2021,Brazil,BRA,578,365,213
2011,Mauritania,MRT,5106,4893,213
2022,Brazil,BRA,790,578,212
2013,Egypt,EGY,2373,2162,211
2012,Chad,TCD,1647,1436,211
2022,Libya,LBY,15485,15275,210
2018,Azerbaijan,AZE,8456,8247,209
2021,Tajikistan,TJK,2053,1845,208
2013,Gambia,GMB,2148,1940,208
2017,Sierra Leone,SLE,2809,2603,206
2011,Bangladesh,BGD,6217,6012,205
2019,Sierra Leone,SLE,3301,3098,203
2012,Mauritania,MRT,5309,5106,203
2015,Burkina Faso,BFA,1067,867,200
2018,South Sudan,SSD,446,248,198
2022,Burundi,BDI,5104,4908,196
2019,Rwanda,RWA,4677,4486,191
2019,Peru,PER,673,484,189
2014,Uganda,UGA,2388,2201,187
2016,El Salvador,SLV,473,286,187
2019,Burkina Faso,BFA,1775,1590,185
2017,Burkina Faso,BFA,1431,1248,183
2016,Guinea-Bissau,GNB,1572,1390,182
2016,Burkina Faso,BFA,1248,1067,181
2018,Niger,NER,847,668,179
2018,Guinea-Bissau,GNB,1970,1793,177
2020,Mauritania,MRT,6633,6456,177
2017,Uganda,UGA,3121,2945,176
2015,Guinea-Bissau,GNB,1390,1214,176
2017,India,IND,1360,1186,174
2021,Djibouti,DJI,1004,830,174
2022,Nepal,NPL,742,572,170
2018,Burundi,BDI,2077,1909,168
2015,Lebanon,LBN,2095,1928,167
2019,India,IND,1692,1525,167
2019,Russian Federation,RUS,54165,53999,166
2021,Kyrgyzstan,KGZ,1350,1184,166
2018,India,IND,1525,1360,165
2017,Mauritania,MRT,6013,5848,165
2011,Palestinian,PSE,3730,3566,164
2021,Gabon,GAB,531,369,162
2011,Haiti,HTI,3698,3538,160
2021,Cambodia,KHM,11397,11238,159
2016,Mauritania,MRT,5848,5689,159
2018,Burkina Faso,BFA,1590,1431,159
2022,Ecuador,ECU,246,88,158
2014,Lebanon,LBN,1928,1774,154
2021,Madagascar,MDG,398,245,153
2016,Chad,TCD,1958,1805,153
2016,Tajikistan,TJK,625,476,149
2019,Djibouti,DJI,798,650,148
2019,Kuwait,KWT,1059,913,146
2021,India,IND,1708,1562,146
2012,Myanmar,MMR,3239,3093,146
2016,Georgia,GEO,5742,5597,145
2019,Western Sahara,ESH,769,624,145
2020,Peru,PER,817,673,144
2022,Gabon,GAB,675,531,144
2018,Uganda,UGA,3265,3121,144
2011,Uzbekistan,UZB,4880,4736,144
2021,Rep. of Moldova,MDA,801,658,143
2011,Cameroon,CMR,4732,4589,143
2014,Yemen,YEM,1526,1383,143
2021,Niger,NER,1129,992,137
2016,Tunisia,TUN,1413,1276,137
2017,Chad,TCD,2094,1958,136
2016,Jordan,JOR,1006,870,136
2017,Tunisia,TUN,1548,1413,135
2013,Hungary,HUN,413,279,134
2019,Congo,COG,5388,5256,132
2022,United Kingdom of Great Britain and Northern Ireland,GBR,188,57,131
2020,Viet Nam,VNM,12027,11897,130
2018,Tunisia,TUN,1678,1548,130
2016,Western Sahara,ESH,461,331,130
2013,Myanmar,MMR,3368,3239,129
2015,Cameroon,CMR,3945,3817,128
2015,Jordan,JOR,870,745,125
2014,North Macedonia,MKD,1460,1337,123
2018,Kuwait,KWT,913,791,122
2021,Jordan,JOR,1342,1220,122
2011,Slovakia,SVK,219,99,120
2015,Western Sahara,ESH,331,213,118
2018,Viet Nam,VNM,11620,11503,117
2018,Gabon,GAB,257,140,117
2021,Lao People's Dem. Rep.,LAO,6699,6582,117
2016,Mongolia,MNG,1263,1147,116
2011,Mongolia,MNG,1022,907,115
2016,Saudi Arabia,SAU,270,156,114
2014,Dem. People's Rep. of Korea,PRK,1092,978,114
2014,Burkina Faso,BFA,867,753,114
2019,South Sudan,SSD,559,446,113
2011,Poland,POL,1309,1196,113
2022,Canada,CAN,157,45,112
2020,Kuwait,KWT,1171,1059,112
2021,Western Sahara,ESH,910,798,112
2011,Kuwait,KWT,849,738,111
2019,Brazil,BRA,350,239,111
2019,Saudi Arabia,SAU,545,435,110
2018,Mauritania,MRT,6123,6013,110
2021,Liberia,LBR,987,878,109
2014,Tunisia,TUN,1201,1093,108
2018,Honduras,HND,313,205,108
2021,Israel,ISR,222,115,107
2012,Belarus,BLR,3801,3695,106
2011,Chad,TCD,1436,1331,105
2020,Guinea,GIN,24112,24007,105
2012,Kuwait,KWT,954,849,105
2016,Djibouti,DJI,503,399,104
2014,Japan,JPN,216,112,104
2019,Gabon,GAB,358,257,101
2021,South Africa,ZAF,468,367,101
2014,Western Sahara,ESH,213,115,98
2015,Chad,TCD,1805,1707,98
2012,Lebanon,LBN,13066,12969,97
2017,Georgia,GEO,5838,5742,96
2021,Chile,CHL,402,306,96
2018,Algeria,DZA,3484,3389,95
2012,Morocco,MAR,2074,1979,95
2018,Colombia,COL,1677,1582,95
2020,Comoros,COM,743,648,95
2015,Mauritania,MRT,5689,5595,94
2019,North Macedonia,MKD,1610,1517,93
2012,United Arab Emirates,ARE,517,424,93
2015,Djibouti,DJI,399,308,91
2022,Benin,BEN,620,529,91
2011,Dem. People's Rep. of Korea,PRK,928,837,91
2017,Western Sahara,ESH,552,461,91
2012,Haiti,HTI,3788,3698,90
2014,Guinea-Bissau,GNB,1214,1125,89
2017,Congo,COG,5250,5161,89
2022,Dominican Rep.,DOM,271,182,89
2020,Saudi Arabia,SAU,633,545,88
2021,Montenegro,MNE,523,435,88
2022,Congo,COG,7205,7117,88
2011,Bhutan,BTN,484,397,87
2017,Saudi Arabia,SAU,357,270,87
2019,Angola,AGO,5945,5858,87
2019,Tunisia,TUN,1765,1678,87
2012,Burkina Faso,BFA,759,672,87
2018,Malaysia,MYS,252,165,87
2015,Kuwait,KWT,850,764,86
2022,South Africa,ZAF,553,468,85
2013,Slovakia,SVK,264,179,85
2014,Mongolia,MNG,1080,996,84
2017,Djibouti,DJI,587,503,84
2015,Poland,POL,1079,996,83
2014,Jordan,JOR,745,662,83
2014,Kazakhstan,KAZ,1463,1380,83
2017,Niger,NER,668,585,83
2019,Mongolia,MNG,1390,1307,83
2017,Benin,BEN,416,334,82
2017,Jordan,JOR,1085,1006,79
2012,Uzbekistan,UZB,4959,4880,79
2011,Uganda,UGA,2289,2210,79
2022,Liberia,LBR,1066,987,79
2017,South Sudan,SSD,248,169,79
2019,Uganda,UGA,3343,3265,78
2012,Kazakhstan,KAZ,2853,2775,78
2022,Germany,DEU,98,20,78
2021,Benin,BEN,529,451,78
2022,Guatemala,GTM,297,219,78
2018,Saudi Arabia,SAU,435,357,78
2015,Malawi,MWI,349,271,78
2022,Philippines,PHL,266,189,77
2019,Benin,BEN,566,489,77
2016,Kazakhstan,KAZ,1574,1498,76
2012,Nepal,NPL,1102,1027,75
2019,Kazakhstan,KAZ,1549,1474,75
2015,Tunisia,TUN,1276,1201,75
2022,Chile,CHL,477,402,75
2018,Benin,BEN,489,416,73
2022,Kenya,KEN,1078,1006,72
2018,Western Sahara,ESH,624,552,72
2018,Rwanda,RWA,4486,4415,71
2018,Haiti,HTI,3623,3553,70
2022,Namibia,NAM,263,193,70
2012,Mongolia,MNG,1091,1022,69
2015,Cuba,CUB,1904,1835,69
2022,Madagascar,MDG,467,398,69
2018,Jordan,JOR,1152,1085,67
2014,Comoros,COM,564,497,67
2011,Jamaica,JAM,557,490,67
2015,Mongolia,MNG,1147,1080,67
2014,Belarus,BLR,2121,2055,66
2022,Djibouti,DJI,1070,1004,66
2016,Benin,BEN,334,269,65
2011,Bahrain,BHR,102,37,65
2021,Namibia,NAM,193,128,65
2015,Benin,BEN,269,204,65
2022,Italy,ITA,106,42,64
2018,Philippines,PHL,192,128,64
2012,Jordan,JOR,1368,1305,63
2018,Djibouti,DJI,650,587,63
2014,Kyrgyzstan,KGZ,1457,1394,63
2014,Myanmar,MMR,3430,3368,62
2016,Venezuela (Bolivarian Republic of),VEN,228,167,61
2014,El Salvador,SLV,225,164,61
2015,El Salvador,SLV,286,225,61
2012,South Sudan,SSD,61,0,61
2013,Comoros,COM,497,437,60
2012,Malawi,MWI,199,140,59
2015,Bahrain,BHR,230,171,59
2021,Turkmenistan,TKM,320,261,59
2021,"China, Hong Kong SAR",HKG,63,5,58
2014,Montenegro,MNE,484,426,58
2014,Mauritania,MRT,5595,5537,58
2017,Haiti,HTI,3553,3495,58
2021,Kenya,KEN,1006,948,58
2011,United Arab Emirates,ARE,424,367,57
2011,Comoros,COM,409,353,56
2011,Belarus,BLR,3695,3639,56
2018,Brazil,BRA,239,184,55
2020,Jordan,JOR,1220,1166,54
2013,Guinea-Bissau,GNB,1125,1071,54
2011,Chile,CHL,598,544,54
2019,Guinea-Bissau,GNB,2024,1970,54
2014,Chad,TCD,1707,1653,54
2019,Malaysia,MYS,306,252,54
2014,Djibouti,DJI,308,254,54
2012,Guinea-Bissau,GNB,1071,1018,53
2019,Guatemala,GTM,138,85,53
2014,India,IND,1273,1220,53
2014,Niger,NER,466,413,53
2012,Bahrain,BHR,155,102,53
2021,Dominican Rep.,DOM,182,130,52
2018,Turkmenistan,TKM,240,188,52
2022,Argentina,ARG,114,62,52
2019,Namibia,NAM,117,65,52
2022,Mexico,MEX,183,132,51
2021,Saudi Arabia,SAU,684,633,51
2017,Kuwait,KWT,791,740,51
2017,United Rep. of Tanzania,TZA,293,243,50
2015,North Macedonia,MKD,1510,1460,50
2016,Armenia,ARM,8542,8492,50
2019,Kenya,KEN,1104,1054,50
2011,South Africa,ZAF,233,183,50
2016,Montenegro,MNE,572,523,49
2018,North Macedonia,MKD,1517,1468,49
2019,Comoros,COM,648,599,49
2015,Tajikistan,TJK,476,428,48
2021,Uganda,UGA,3370,3322,48
2012,Rep. of Korea,KOR,205,157,48
2020,Paraguay,PRY,70,23,47
2015,Zambia,ZMB,126,79,47
2017,Viet Nam,VNM,11503,11456,47
2017,Jamaica,JAM,605,559,46
2019,Jamaica,JAM,687,641,46
2014,Bahrain,BHR,171,125,46
2020,Malaysia,MYS,351,306,45
2014,Kenya,KEN,1004,959,45
2018,Peru,PER,484,439,45
2011,Malawi,MWI,140,95,45
2015,South Sudan,SSD,154,109,45
2013,Malawi,MWI,244,199,45
2015,Venezuela (Bolivarian Republic of),VEN,167,122,45
2019,Dominican Rep.,DOM,141,97,44
2020,Guatemala,GTM,182,138,44
2017,Honduras,HND,205,161,44
2013,Western Sahara,ESH,115,72,43
2021,Mexico,MEX,132,89,43
2017,Brazil,BRA,184,141,43
2021,Nepal,NPL,572,529,43
2014,Cuba,CUB,1835,1793,42
2014,South Sudan,SSD,109,67,42
2022,Lithuania,LTU,62,21,41
2019,Armenia,ARM,9277,9236,41
2018,Trinidad and Tobago,TTO,161,120,41
2017,Gabon,GAB,140,99,41
2016,Jamaica,JAM,559,518,41
2019,Philippines,PHL,233,192,41
2013,Greece,GRC,46,5,41
2018,United Rep. of Tanzania,TZA,334,293,41
2019,Malawi,MWI,459,419,40
2018,Rep. of Korea,KOR,103,63,40
2022,South Sudan,SSD,887,847,40
2022,Panama,PAN,59,19,40
2015,South Africa,ZAF,283,244,39
2022,Equatorial Guinea,GNQ,171,132,39
2015,Montenegro,MNE,523,484,39
2022,United Rep. of Tanzania,TZA,405,366,39
2016,Kenya,KEN,1062,1023,39
2012,Western Sahara,ESH,72,34,38
2011,Saudi Arabia,SAU,437,399,38
2012,Niger,NER,531,493,38
2015,Hungary,HUN,435,398,37
2022,Zambia,ZMB,161,124,37
2021,Guatemala,GTM,219,182,37
2012,Saudi Arabia,SAU,474,437,37
2012,Tajikistan,TJK,424,387,37
2021,United Rep. of Tanzania,TZA,366,330,36
2021,United Kingdom of Great Britain and Northern Ireland,GBR,57,21,36
2018,Jamaica,JAM,641,605,36
2014,Tajikistan,TJK,428,392,36
2015,Kazakhstan,KAZ,1498,1463,35
2021,Malaysia,MYS,385,351,34
2018,Malawi,MWI,419,385,34
2022,Paraguay,PRY,110,76,34
2015,United Rep. of Tanzania,TZA,247,213,34
2012,Philippines,PHL,332,298,34
2014,Kuwait,KWT,764,731,33
2015,Honduras,HND,130,97,33
2022,Niger,NER,1162,1129,33
2020,South Africa,ZAF,367,334,33
2016,North Macedonia,MKD,1543,1510,33
2016,Azerbaijan,AZE,7602,7569,33
2011,El Salvador,SLV,116,83,33
2018,Bahrain,BHR,290,258,32
2020,Djibouti,DJI,830,798,32
2018,Liberia,LBR,935,903,32
2021,Philippines,PHL,189,157,32
2021,Tibetan,TIB,43,11,32
2022,Malaysia,MYS,416,385,31
2013,El Salvador,SLV,164,133,31
2015,Eswatini,SWZ,69,38,31
2012,Honduras,HND,90,59,31
2021,Slovakia,SVK,214,183,31
2015,Saudi Arabia,SAU,156,125,31
2016,Honduras,HND,161,130,31
2019,Dem. People's Rep. of Korea,PRK,317,287,30
2017,Kyrgyzstan,KGZ,1421,1391,30
2012,Djibouti,DJI,226,196,30
2015,Jamaica,JAM,518,488,30
2011,Venezuela (Bolivarian Republic of),VEN,98,69,29
2011,Ecuador,ECU,436,407,29
2014,Benin,BEN,204,175,29
2017,Trinidad and Tobago,TTO,120,91,29
2020,Western Sahara,ESH,798,769,29
2011,Burkina Faso,BFA,672,643,29
2011,Western Sahara,ESH,34,5,29
2017,Comoros,COM,590,562,28
2015,Malaysia,MYS,118,90,28
2017,Mongolia,MNG,1291,1263,28
2017,United Arab Emirates,ARE,56,28,28
2011,Niger,NER,493,465,28
2017,Malaysia,MYS,165,137,28
2013,Djibouti,DJI,254,226,28
2011,Malaysia,MYS,82,54,28
2012,Comoros,COM,437,409,28
2020,United States of America,USA,268,240,28
2022,Bolivia (Plurinational State of),BOL,206,178,28
2016,Trinidad and Tobago,TTO,91,64,27
2012,Dem. People's Rep. of Korea,PRK,955,928,27
2016,Comoros,COM,562,535,27
2014,Malawi,MWI,271,244,27
2019,Bahrain,BHR,317,290,27
2014,Venezuela (Bolivarian Republic of),VEN,122,95,27
2012,Qatar,QAT,109,82,27
2018,Nicaragua,NIC,60,34,26
2022,Greece,GRC,93,67,26
2022,Rep. of Korea,KOR,65,39,26
2015,Myanmar,MMR,3456,3430,26
2014,Rep. of Korea,KOR,168,143,25
2022,France,FRA,46,21,25
2011,Lithuania,LTU,319,294,25
2018,Namibia,NAM,65,40,25
2021,Bolivia (Plurinational State of),BOL,178,154,24
2017,Peru,PER,439,416,23
2022,Botswana,BWA,74,51,23
2022,Latvia,LVA,76,53,23
2022,Eswatini,SWZ,106,83,23
2014,Honduras,HND,97,74,23
2013,Dem. People's Rep. of Korea,PRK,978,955,23
2021,Mauritius,MUS,144,121,23
2016,Philippines,PHL,114,92,22
2011,Guatemala,GTM,56,34,22
2019,United Rep. of Tanzania,TZA,356,334,22
2022,Portugal,PRT,33,11,22
2016,Gabon,GAB,99,77,22
2012,Cuba,CUB,1985,1963,22
2014,Georgia,GEO,5669,5647,22
2021,Equatorial Guinea,GNQ,132,110,22
2019,Botswana,BWA,48,27,21
2012,Malaysia,MYS,103,82,21
2012,Mauritius,MUS,35,14,21
2019,Rep. of Moldova,MDA,790,769,21
2019,South Africa,ZAF,334,313,21
2021,Ecuador,ECU,88,67,21
2022,Uruguay,URY,32,12,20
2022,Australia,AUS,31,11,20
2014,Bolivia (Plurinational State of),BOL,163,143,20
2011,Kenya,KEN,1332,1312,20
2021,United States of America,USA,288,268,20
2017,Dominican Rep.,DOM,87,67,20
2011,Madagascar,MDG,250,231,19
2021,Indonesia,IDN,116,97,19
2015,Trinidad and Tobago,TTO,64,45,19
2016,Malaysia,MYS,137,118,19
2021,Argentina,ARG,62,43,19
2016,Malawi,MWI,368,349,19
2022,Japan,JPN,42,23,19
2015,Kenya,KEN,1023,1004,19
2017,Mauritius,MUS,87,68,19
2012,Mexico,MEX,73,55,18
2018,Mauritius,MUS,105,87,18
2022,Austria,AUT,23,5,18
2018,Mexico,MEX,89,71,18
2011,Djibouti,DJI,196,178,18
2017,Bahrain,BHR,258,241,17
2012,Madagascar,MDG,267,250,17
2012,El Salvador,SLV,133,116,17
2017,Malawi,MWI,385,368,17
2019,Mauritius,MUS,122,105,17
2014,Israel,ISR,124,108,16
2014,Trinidad and Tobago,TTO,45,29,16
2019,Mexico,MEX,105,89,16
2011,Guinea-Bissau,GNB,1018,1002,16
2012,Guatemala,GTM,72,56,16
2011,Japan,JPN,139,123,16
2020,Turkmenistan,TKM,261,245,16
2012,Venezuela (Bolivarian Republic of),VEN,114,98,16
2019,Liberia,LBR,951,935,16
2018,Mongolia,MNG,1307,1291,16
2020,Trinidad and Tobago,TTO,187,171,16
2022,Montenegro,MNE,538,523,15
2011,Brazil,BRA,202,187,15
2016,South Africa,ZAF,298,283,15
2014,Zambia,ZMB,79,64,15
2020,Brazil,BRA,365,350,15
2011,Gabon,GAB,68,53,15
2021,Guyana,GUY,59,44,15
2016,South Sudan,SSD,169,154,15
2011,Benin,BEN,315,301,14
2014,Dominican Rep.,DOM,50,36,14
2020,Cameroon,CMR,7328,7314,14
2022,Thailand,THA,97,83,14
2019,Equatorial Guinea,GNQ,120,106,14
2016,Cuba,CUB,1918,1904,14
2015,Chile,CHL,344,330,14
2019,Indonesia,IDN,88,74,14
2019,United States of America,USA,240,226,14
2013,Mauritius,MUS,49,35,14
2017,Philippines,PHL,128,114,14
2019,Togo,TGO,3712,3698,14
2015,Nepal,NPL,890,876,14
2019,Jordan,JOR,1166,1152,14
2016,Eswatini,SWZ,82,69,13
2019,United Arab Emirates,ARE,77,64,13
2012,Bhutan,BTN,497,484,13
2014,Brazil,BRA,139,126,13
2015,Dominican Rep.,DOM,63,50,13
2016,Mexico,MEX,71,58,13
2012,Zambia,ZMB,65,52,13
2018,Indonesia,IDN,74,61,13
2013,South Africa,ZAF,244,231,13
2016,United Arab Emirates,ARE,28,15,13
2022,Mauritius,MUS,157,144,13
2012,Trinidad and Tobago,TTO,32,19,13
2022,Spain,ESP,39,26,13
2019,Zambia,ZMB,131,119,12
2018,Maldives,MDV,42,30,12
2021,Uruguay,URY,12,0,12
2013,Eswatini,SWZ,27,15,12
2011,Trinidad and Tobago,TTO,19,7,12
2014,Nepal,NPL,876,864,12
2020,Panama,PAN,12,0,12
2011,Mozambique,MOZ,126,114,12
2018,Kyrgyzstan,KGZ,1433,1421,12
2018,Zambia,ZMB,119,107,12
2011,Ethiopia,ETH,12947,12936,11
2018,Costa Rica,CRI,11,0,11
2011,Morocco,MAR,1979,1968,11
2014,Indonesia,IDN,86,75,11
2020,Gabon,GAB,369,358,11
2022,Poland,POL,817,806,11
2020,Namibia,NAM,128,117,11
2019,Netherlands (Kingdom of the),NLD,36,25,11
2014,Greece,GRC,57,46,11
2016,Bahrain,BHR,241,230,11
2016,Bolivia (Plurinational State of),BOL,173,162,11
2014,Saudi Arabia,SAU,125,114,11
2014,Eswatini,SWZ,38,27,11
2012,United States of America,USA,384,373,11
2019,Bolivia (Plurinational State of),BOL,167,157,10
2022,Indonesia,IDN,126,116,10
2022,Belgium,BEL,17,7,10
2012,Canada,CAN,58,48,10
2011,Mexico,MEX,55,45,10
2014,United Rep. of Tanzania,TZA,213,203,10
2019,Trinidad and Tobago,TTO,171,161,10
2022,Saudi Arabia,SAU,694,684,10
2011,Zambia,ZMB,52,42,10
2018,Dominican Rep.,DOM,97,87,10
2022,Rwanda,RWA,6045,6035,10
2013,Central African Rep.,CAF,672,662,10
2018,Italy,ITA,37,27,10
2022,Cabo Verde,CPV,20,10,10
2022,North Macedonia,MKD,1722,1712,10
2011,Indonesia,IDN,180,170,10
2011,Israel,ISR,430,420,10
2021,Hungary,HUN,336,326,10
2021,Qatar,QAT,22,13,9
2012,Guyana,GUY,17,8,9
2022,Sweden,SWE,18,9,9
2018,Comoros,COM,599,590,9
2019,Dominica,DMA,26,17,9
2017,Namibia,NAM,40,31,9
2018,Saint Vincent and the Grenadines,VCT,31,22,9
2020,Indonesia,IDN,97,88,9
2016,Brazil,BRA,141,132,9
2020,Argentina,ARG,43,34,9
2017,Germany,DEU,21,12,9
2011,United States of America,USA,373,364,9
2019,Saint Vincent and the Grenadines,VCT,40,31,9
2016,Israel,ISR,129,121,8
2022,Ireland,IRL,8,0,8
2016,Madagascar,MDG,254,246,8
2012,Namibia,NAM,20,12,8
2012,Mozambique,MOZ,134,126,8
2022,Switzerland,CHE,8,0,8
2012,Central African Rep.,CAF,662,654,8
2018,United Arab Emirates,ARE,64,56,8
2014,Thailand,THA,136,128,8
2017,Greece,GRC,71,63,8
2014,Guatemala,GTM,80,72,8
2020,Dominica,DMA,34,26,8
2011,United Rep. of Tanzania,TZA,231,223,8
2019,Eswatini,SWZ,92,84,8
2012,Fiji,FJI,8,0,8
2022,Trinidad and Tobago,TTO,202,194,8
2018,South Africa,ZAF,313,305,8
2013,France,FRA,15,7,8
2014,Philippines,PHL,121,113,8
2017,Singapore,SGP,12,5,7
2017,Netherlands (Kingdom of the),NLD,21,14,7
2019,Germany,DEU,21,14,7
2015,Nicaragua,NIC,24,17,7
2019,Italy,ITA,44,37,7
2021,Trinidad and Tobago,TTO,194,187,7
2021,Latvia,LVA,53,46,7
2012,Spain,ESP,20,13,7
2018,Argentina,ARG,36,29,7
2012,Netherlands (Kingdom of the),NLD,23,16,7
2014,Mauritius,MUS,56,49,7
2011,Latvia,LVA,530,523,7
2019,Saint Lucia,LCA,29,22,7
2017,Botswana,BWA,24,17,7
2021,Italy,ITA,42,35,7
2015,Namibia,NAM,24,17,7
2016,Mauritius,MUS,68,61,7
2014,Gabon,GAB,74,67,7
2021,Panama,PAN,19,12,7
2015,Madagascar,MDG,246,239,7
2017,South Africa,ZAF,305,298,7
2016,Nicaragua,NIC,31,24,7
2022,Saint Lucia,LCA,40,33,7
2022,New Zealand,NZL,14,7,7
2016,Namibia,NAM,31,24,7
2011,Nicaragua,NIC,19,12,7
2015,Oman,OMN,13,6,7
2016,Argentina,ARG,23,17,6
2012,Brazil,BRA,208,202,6
2013,South Sudan,SSD,67,61,6
2017,Grenada,GRD,15,9,6
2017,Argentina,ARG,29,23,6
2019,Paraguay,PRY,23,17,6
2017,Maldives,MDV,30,24,6
2016,Saint Lucia,LCA,16,10,6
2020,Tibetan,TIB,11,5,6
2011,Germany,DEU,21,15,6
2012,Eswatini,SWZ,15,9,6
2016,Saint Kitts and Nevis,KNA,6,0,6
2018,Barbados,BRB,11,5,6
2022,Dominica,DMA,38,32,6
2021,Thailand,THA,83,77,6
2018,Equatorial Guinea,GNQ,106,100,6
2017,Israel,ISR,135,129,6
2021,Paraguay,PRY,76,70,6
2015,Saint Vincent and the Grenadines,VCT,14,8,6
2015,Maldives,MDV,18,12,6
2015,Guyana,GUY,27,21,6
2013,Chad,TCD,1653,1647,6
2015,Botswana,BWA,17,11,6
2018,Congo,COG,5256,5250,6
2012,Paraguay,PRY,13,7,6
2015,Peru,PER,428,422,6
2018,Madagascar,MDG,260,254,6
2021,Canada,CAN,45,39,6
2017,Cuba,CUB,1924,1918,6
2018,Dominica,DMA,17,11,6
2018,Thailand,THA,80,74,6
2018,Canada,CAN,39,33,6
2021,Suriname,SUR,11,5,6
2016,Maldives,MDV,24,18,6
2021,Cabo Verde,CPV,10,5,5
2021,Netherlands (Kingdom of the),NLD,41,36,5
2021,Liechtenstein,LIE,5,0,5
2021,Maldives,MDV,52,47,5
2022,Sao Tome and Principe,STP,5,0,5
2011,Mauritius,MUS,14,9,5
2022,Turks and Caicos Islands,TCA,5,0,5
2016,Guyana,GUY,32,27,5
2021,Mozambique,MOZ,49,44,5
2016,Canada,CAN,33,28,5
2021,Romania,ROU,430,425,5
2022,Lesotho,LSO,5,0,5
2021,Lithuania,LTU,21,16,5
2022,Luxembourg,LUX,5,0,5
2017,Zambia,ZMB,107,102,5
2011,Belgium,BEL,37,32,5
2018,Spain,ESP,22,17,5
2022,Antigua and Barbuda,ATG,10,5,5
2018,Grenada,GRD,20,15,5
2018,France,FRA,25,20,5
2018,Cabo Verde,CPV,10,5,5
2018,Oman,OMN,25,20,5
2018,Guyana,GUY,37,32,5
2022,Costa Rica,CRI,10,5,5
2018,Suriname,SUR,5,0,5
2017,Iceland,ISL,5,0,5
2017,Barbados,BRB,5,0,5
2017,Norway,NOR,15,10,5
2017,Austria,AUT,5,0,5
2017,Paraguay,PRY,16,11,5
2017,United Kingdom of Great Britain and Northern Ireland,GBR,25,20,5
2018,Antigua and Barbuda,ATG,5,0,5
2018,Seychelles,SYC,5,0,5
2020,"China, Hong Kong SAR",HKG,5,0,5
2016,Bahamas,BHS,5,0,5
2022,Palau,PLW,5,0,5
2020,Guyana,GUY,44,39,5
2016,Belize,BLZ,5,0,5
2020,Estonia,EST,15,10,5
2016,Saint Vincent and the Grenadines,VCT,19,14,5
2011,Panama,PAN,5,0,5
2019,Luxembourg,LUX,5,0,5
2018,Bahamas,BHS,10,5,5
2022,Hungary,HUN,341,336,5
2016,Solomon Islands,SLB,5,0,5
2019,Qatar,QAT,10,5,5
2011,Norway,NOR,5,0,5
2019,Turkmenistan,TKM,245,240,5
2012,Benin,BEN,320,315,5
2016,Tibetan,TIB,5,0,5
2022,Anguilla,AIA,5,0,5
2015,Turkmenistan,TKM,202,197,5
2012,Saint Vincent and the Grenadines,VCT,5,0,5
2015,Paraguay,PRY,10,5,5
2012,Austria,AUT,10,5,5
2012,Panama,PAN,10,5,5
2012,Dominican Rep.,DOM,50,45,5
2015,Dominica,DMA,5,0,5
2015,Mauritius,MUS,61,56,5
2014,Cabo Verde,CPV,27,22,5
2013,Norway,NOR,10,5,5
2014,Timor-Leste,TLS,5,0,5
2012,Saint Lucia,LCA,5,0,5
2015,United Arab Emirates,ARE,15,10,5
2014,Sao Tome and Principe,STP,5,0,5
2014,Qatar,QAT,5,0,5
2014,Denmark,DNK,5,0,5
2015,France,FRA,19,14,5
2014,Portugal,PRT,10,5,5
2014,Namibia,NAM,17,12,5
2012,Seychelles,SYC,5,0,5
2016,Dominican Rep.,DOM,67,63,4
2020,Germany,DEU,25,21,4
2021,Botswana,BWA,51,47,4
2014,Germany,DEU,19,15,4
2016,Oman,OMN,17,13,4
2015,Saint Lucia,LCA,10,6,4
2016,Mozambique,MOZ,38,34,4
2019,Grenada,GRD,24,20,4
2011,Argentina,ARG,41,37,4
2017,Estonia,EST,17,13,4
2011,Costa Rica,CRI,13,9,4
2018,Netherlands (Kingdom of the),NLD,25,21,4
2012,Italy,ITA,23,19,4
2018,Mozambique,MOZ,40,36,4
2021,Seychelles,SYC,9,5,4
2017,Montenegro,MNE,576,572,4
2017,Ecuador,ECU,116,112,4
2017,Guatemala,GTM,84,80,4
2017,Dominica,DMA,11,7,4
2014,Malaysia,MYS,90,86,4
2017,Saint Lucia,LCA,19,16,3
2015,Gabon,GAB,77,74,3
2019,Maldives,MDV,45,42,3
2011,Thailand,THA,279,276,3
2017,Saint Vincent and the Grenadines,VCT,22,19,3
2017,Nicaragua,NIC,34,31,3
2016,Greece,GRC,63,60,3
2019,Spain,ESP,25,22,3
2014,United Arab Emirates,ARE,10,7,3
2013,Maldives,MDV,12,9,3
2018,United States of America,USA,226,223,3
2018,Botswana,BWA,27,24,3
2011,Honduras,HND,59,56,3
2020,Qatar,QAT,13,10,3
2021,Saint Vincent and the Grenadines,VCT,44,41,3
2014,Mexico,MEX,64,61,3
2014,Spain,ESP,20,17,3
2017,Solomon Islands,SLB,8,5,3
2017,Eswatini,SWZ,85,82,3
2012,Australia,AUS,36,33,3
2017,Oman,OMN,20,17,3
2011,Estonia,EST,117,114,3
2022,Singapore,SGP,15,12,3
2022,Netherlands (Kingdom of the),NLD,44,41,3
2012,Oman,OMN,50,47,3
2011,Italy,ITA,19,16,3
2022,Guyana,GUY,62,59,3
2015,Greece,GRC,60,57,3
2022,Suriname,SUR,14,11,3
2020,Saint Lucia,LCA,32,29,3
2012,Gabon,GAB,71,68,3
2018,Saint Lucia,LCA,22,19,3
2019,Mozambique,MOZ,43,40,3
2019,Oman,OMN,28,25,3
2014,United Kingdom of Great Britain and Northern Ireland,GBR,17,14,3
2019,Greece,GRC,74,72,2
2014,Saint Vincent and the Grenadines,VCT,8,6,2
2016,Netherlands (Kingdom of the),NLD,14,12,2
2017,Italy,ITA,27,25,2
2019,France,FRA,27,25,2
2018,Saint Kitts and Nevis,KNA,8,6,2
2019,Guyana,GUY,39,37,2
2022,Mozambique,MOZ,51,49,2
2020,Portugal,PRT,12,10,2
2018,Sweden,SWE,8,6,2
2021,Oman,OMN,30,28,2
2018,United Kingdom of Great Britain and Northern Ireland,GBR,27,25,2
2020,Maldives,MDV,47,45,2
2020,Grenada,GRD,26,24,2
2011,New Zealand,NZL,13,11,2
2016,Guatemala,GTM,80,78,2
2019,Barbados,BRB,13,11,2
2011,Bolivia (Plurinational State of),BOL,187,185,2
2011,Canada,CAN,48,46,2
2014,Guyana,GUY,21,19,2
2020,Spain,ESP,27,25,2
2019,Thailand,THA,82,80,2
2012,Argentina,ARG,43,41,2
2017,Latvia,LVA,63,61,2
2013,Guyana,GUY,19,17,2
2020,Mongolia,MNG,1392,1390,2
2016,United Kingdom of Great Britain and Northern Ireland,GBR,20,18,2
2016,Dominica,DMA,7,5,2
2012,Turkmenistan,TKM,390,388,2
2011,Netherlands (Kingdom of the),NLD,16,14,2
2020,Malawi,MWI,461,459,2
2012,Slovenia,SVN,12,10,2
2019,Madagascar,MDG,262,260,2
2021,Saint Lucia,LCA,33,32,1
2014,Netherlands (Kingdom of the),NLD,15,14,1
2017,Turkmenistan,TKM,188,187,1
2012,Nicaragua,NIC,20,19,1
2017,Sweden,SWE,6,5,1
2013,Grenada,GRD,6,5,1
2015,Italy,ITA,24,23,1
2015,Grenada,GRD,8,7,1
2012,Singapore,SGP,9,8,1
2017,Portugal,PRT,11,10,1
2018,Paraguay,PRY,17,16,1
2012,New Zealand,NZL,14,13,1
2021,Sweden,SWE,9,8,1
2018,Singapore,SGP,13,12,1
2022,Saint Kitts and Nevis,KNA,7,6,1
2019,Fiji,FJI,9,8,1
2021,Belgium,BEL,7,6,1
2014,Oman,OMN,6,5,1
2021,Australia,AUS,11,10,1
2020,Barbados,BRB,14,13,1
2022,Slovenia,SVN,7,6,1
2020,Latvia,LVA,46,45,1
2014,Nicaragua,NIC,17,16,1
2016,Grenada,GRD,9,8,1
2016,Fiji,FJI,9,8,1
2017,Qatar,QAT,6,5,1
2014,Grenada,GRD,7,6,1
2013,Saint Vincent and the Grenadines,VCT,6,5,1
2016,Italy,ITA,25,24,1
2011,Guyana,GUY,8,7,1
2011,United Kingdom of Great Britain and Northern Ireland,GBR,28,27,1
2014,Saint Lucia,LCA,6,5,1
2012,Thailand,THA,280,279,1
2011,Botswana,BWA,14,13,1
2015,United Kingdom of Great Britain and Northern Ireland,GBR,18,17,1
2011,Eswatini,SWZ,9,8,1
2016,United States of America,USA,226,225,1
2018,Guatemala,GTM,85,84,1
2019,Belgium,BEL,6,5,1
2017,Belgium,BEL,6,5,1
2020,Mozambique,MOZ,44,43,1
2018,Greece,GRC,72,71,1
2020,France,FRA,28,27,1
2016,Paraguay,PRY,11,10,1
2019,Canada,CAN,40,39,1
2017,France,FRA,20,19,1
2021,Saint Kitts and Nevis,KNA,6,5,1
2020,Saint Vincent and the Grenadines,VCT,41,40,1
2021,Barbados,BRB,15,14,1
2014,Italy,ITA,23,22,1
2018,Timor-Leste,TLS,5,5,0
2011,Paraguay,PRY,7,7,0
2012,Sao Tome and Principe,,0,0,0
2015,Algeria,DZA,2844,2844,0
2018,Nauru,,0,0,0
2018,Belize,BLZ,5,5,0
2018,Austria,AUT,5,5,0
2020,Lithuania,LTU,16,16,0
2018,Kiribati,,0,0,0
2018,Fiji,FJI,8,8,0
2018,Panama,PAN,0,0,0
2018,"China, Macao SAR",,0,0,0
2018,Switzerland,,0,0,0
2012,Antigua and Barbuda,ATG,0,0,0
2018,New Zealand,NZL,8,8,0
2020,Nauru,,0,0,0
2020,Singapore,SGP,13,13,0
2020,Slovenia,SVN,6,6,0
2020,Sweden,SWE,8,8,0
2020,Switzerland,,0,0,0
2020,Antigua and Barbuda,ATG,5,5,0
2020,Suriname,SUR,5,5,0
2020,"China, Macao SAR",MAC,0,0,0
2012,Iceland,,0,0,0
2020,Kiribati,,0,0,0
2020,Austria,AUT,5,5,0
2020,Norway,NOR,5,5,0
2020,Uruguay,URY,0,0,0
2020,Fiji,FJI,9,9,0
2020,Seychelles,SYC,5,5,0
2020,Samoa,WSM,0,0,0
2020,Palau,,0,0,0
2012,Sweden,SWE,5,5,0
2020,Sao Tome and Principe,STP,5,5,0
2020,Lesotho,LSO,0,0,0
2020,Denmark,,0,0,0
2020,Solomon Islands,SLB,6,6,0
2020,Iceland,ISL,5,5,0
2020,New Zealand,NZL,8,8,0
2020,Netherlands (Kingdom of the),NLD,36,36,0
2012,Solomon Islands,,0,0,0
2020,Japan,JPN,23,23,0
2012,Lesotho,,0,0,0
2012,Bahamas,,0,0,0
2012,Denmark,,0,0,0
2012,Dominica,DMA,0,0,0
2018,Australia,AUS,10,10,0
2012,Timor-Leste,TLS,0,0,0
2012,Norway,NOR,5,5,0
2020,Cyprus,CYP,0,0,0
2012,Nauru,,0,0,0
2012,Saint Kitts and Nevis,,0,0,0
2012,Belize,,0,0,0
2020,Oman,OMN,28,28,0
2018,Cyprus,CYP,0,0,0
2014,Turkmenistan,TKM,197,197,0
2012,Greece,GRC,5,5,0
2012,"China, Hong Kong SAR",,0,0,0
2020,Australia,AUS,10,10,0
2020,Belgium,BEL,6,6,0
2018,Palau,,0,0,0
2018,Tibetan,TIB,5,5,0
2018,Uruguay,URY,0,0,0
2018,Samoa,,0,0,0
2014,Finland,,0,0,0
2012,Samoa,WSM,0,0,0
2019,"China, Hong Kong SAR",HKG,0,0,0
2019,Uruguay,URY,0,0,0
2019,Samoa,,0,0,0
2019,Palau,,0,0,0
2014,Antigua and Barbuda,,0,0,0
2019,Sao Tome and Principe,STP,5,5,0
2011,Saint Lucia,,0,0,0
2014,Suriname,SUR,0,0,0
2014,"China, Macao SAR",,0,0,0
2019,Lesotho,LSO,0,0,0
2019,Bahamas,BHS,10,10,0
2011,Saint Vincent and the Grenadines,,0,0,0
2019,Denmark,,0,0,0
2011,Seychelles,,0,0,0
2019,Saint Kitts and Nevis,KNA,8,8,0
2011,Samoa,,0,0,0
2014,Switzerland,,0,0,0
2019,Solomon Islands,SLB,6,6,0
2019,Iceland,ISL,5,5,0
2014,Panama,,0,0,0
2019,Finland,FIN,0,0,0
2014,Austria,,0,0,0
2014,Belize,,0,0,0
2011,Palau,,0,0,0
2011,Barbados,,0,0,0
2011,Sao Tome and Principe,,0,0,0
2011,Lesotho,,0,0,0
2019,Liechtenstein,LIE,0,0,0
2014,Nauru,,0,0,0
2011,Bahamas,,0,0,0
2014,Norway,NOR,10,10,0
2019,Tibetan,TIB,5,5,0
2019,Seychelles,SYC,5,5,0
2018,Sao Tome and Principe,STP,5,5,0
2019,New Zealand,NZL,8,8,0
2019,Belize,BLZ,5,5,0
2019,Austria,AUT,5,5,0
2019,Kiribati,,0,0,0
2019,Panama,PAN,0,0,0
2019,"China, Macao SAR",MAC,0,0,0
2019,Suriname,SUR,5,5,0
2019,Antigua and Barbuda,ATG,5,5,0
2019,Norway,NOR,5,5,0
2014,Maldives,MDV,12,12,0
2019,Switzerland,CHE,0,0,0
2019,Sweden,SWE,8,8,0
2019,Slovenia,SVN,6,6,0
2019,Singapore,SGP,13,13,0
2019,Portugal,PRT,10,10,0
2019,Timor-Leste,TLS,5,5,0
2014,Sweden,SWE,5,5,0
2014,Australia,AUS,21,21,0
2014,Belgium,BEL,18,18,0
2014,Canada,CAN,40,40,0
2019,Cabo Verde,CPV,10,10,0
2019,Costa Rica,CRI,11,11,0
2014,Cyprus,CYP,5,5,0
2019,Australia,AUS,10,10,0
2011,Timor-Leste,,0,0,0
2019,Cyprus,CYP,0,0,0
2014,Paraguay,PRY,5,5,0
2014,Singapore,SGP,7,7,0
2011,Dominica,,0,0,0
2014,Botswana,BWA,11,11,0
2011,Fiji,,0,0,0
2014,Dominica,,0,0,0
2019,Marshall Islands,,0,0,0
2014,Fiji,FJI,8,8,0
2011,Singapore,SGP,8,8,0
2014,Iceland,,0,0,0
2011,Antigua and Barbuda,,0,0,0
2014,Tibetan,,0,0,0
2020,Luxembourg,LUX,5,5,0
2014,Uruguay,URY,5,5,0
2014,Luxembourg,,0,0,0
2014,Liechtenstein,,0,0,0
2011,Switzerland,CHE,10,10,0
2014,Marshall Islands,,0,0,0
2014,Turks and Caicos Islands,,0,0,0
2014,Vanuatu,,0,0,0
2014,Ireland,,0,0,0
2014,Anguilla,,0,0,0
2011,Sweden,SWE,5,5,0
2011,Portugal,PRT,10,10,0
2011,Denmark,,0,0,0
2012,Barbados,,0,0,0
2018,Anguilla,,0,0,0
2018,Ireland,,0,0,0
2018,Vanuatu,,0,0,0
2018,Turks and Caicos Islands,,0,0,0
2018,Marshall Islands,,0,0,0
2018,Liechtenstein,,0,0,0
2018,Luxembourg,,0,0,0
2018,Finland,,0,0,0
2018,Iceland,ISL,5,5,0
2018,"China, Hong Kong SAR",HKG,0,0,0
2018,Denmark,,0,0,0
2012,Palau,,0,0,0
2018,Lesotho,LSO,0,0,0
2011,Suriname,SUR,5,5,0
2011,"China, Macao SAR",MAC,8,8,0
2011,Greece,GRC,5,5,0
2011,Kiribati,KIR,31,31,0
2011,Saint Kitts and Nevis,,0,0,0
2011,"China, Hong Kong SAR",,0,0,0
2019,Turks and Caicos Islands,,0,0,0
2019,Vanuatu,,0,0,0
2019,Ireland,,0,0,0
2011,Solomon Islands,,0,0,0
2011,Iceland,,0,0,0
2014,Seychelles,,0,0,0
2014,Samoa,,0,0,0
2011,Finland,,0,0,0
2019,Anguilla,,0,0,0
2014,Palau,,0,0,0
2011,Luxembourg,,0,0,0
2014,Barbados,BRB,0,0,0
2011,South Sudan,SSD,0,0,0
2014,Lesotho,LSO,0,0,0
2014,Bahamas,BHS,0,0,0
2011,Nauru,NRU,0,0,0
2011,Belize,BLZ,0,0,0
2011,Liechtenstein,,0,0,0
2011,Austria,AUT,5,5,0
2011,Marshall Islands,,0,0,0
2014,Saint Kitts and Nevis,,0,0,0
2014,"China, Hong Kong SAR",,0,0,0
2011,Turks and Caicos Islands,,0,0,0
2011,Vanuatu,,0,0,0
2011,Ireland,,0,0,0
2014,Solomon Islands,,0,0,0
2011,Anguilla,,0,0,0
2020,Finland,,0,0,0
2012,Liechtenstein,,0,0,0
2020,Liechtenstein,LIE,0,0,0
2013,Dominica,DMA,0,0,0
2015,Liechtenstein,,0,0,0
2021,"China, Macao SAR",,0,0,0
2015,Marshall Islands,,0,0,0
2021,Kiribati,,0,0,0
2015,Turks and Caicos Islands,,0,0,0
2015,Vanuatu,,0,0,0
2021,Austria,AUT,5,5,0
2015,Ireland,,0,0,0
2021,Belize,BLZ,0,0,0
2021,Nauru,,0,0,0
2021,Norway,NOR,5,5,0
2015,Anguilla,,0,0,0
2021,Timor-Leste,,0,0,0
2021,Samoa,WSM,0,0,0
2012,Tibetan,,0,0,0
2012,Indonesia,IDN,180,180,0
2021,Palau,,0,0,0
2021,Lesotho,LSO,0,0,0
2021,Bahamas,,0,0,0
2021,Denmark,,0,0,0
2012,Grenada,GRD,5,5,0
2021,Solomon Islands,SLB,6,6,0
2021,Finland,,0,0,0
2021,Marshall Islands,,0,0,0
2021,Turks and Caicos Islands,TCA,0,0,0
2021,Vanuatu,VUT,0,0,0
2021,Ireland,,0,0,0
2021,Anguilla,,0,0,0
2012,Cabo Verde,CPV,22,22,0
2013,Cabo Verde,CPV,22,22,0
2021,Antigua and Barbuda,ATG,5,5,0
2015,Luxembourg,,0,0,0
2015,Samoa,,0,0,0
2017,Tibetan,TIB,5,5,0
2013,Timor-Leste,TLS,0,0,0
2015,Norway,NOR,10,10,0
2013,Nauru,,0,0,0
2013,Belize,,0,0,0
2015,Timor-Leste,TLS,5,5,0
2015,Fiji,FJI,8,8,0
2021,Cyprus,CYP,0,0,0
2013,"China, Macao SAR",,0,0,0
2013,Suriname,SUR,0,0,0
2013,Antigua and Barbuda,,0,0,0
2013,Sweden,SWE,5,5,0
2015,Seychelles,,0,0,0
2015,Palau,,0,0,0
2021,Switzerland,,0,0,0
2015,Barbados,BRB,0,0,0
2015,Sao Tome and Principe,STP,5,5,0
2015,Lesotho,LSO,0,0,0
2021,Japan,JPN,23,23,0
2015,Bahamas,BHS,0,0,0
2015,Denmark,DNK,5,5,0
2015,Saint Kitts and Nevis,KNA,0,0,0
2015,"China, Hong Kong SAR",,0,0,0
2015,Solomon Islands,,0,0,0
2021,Slovenia,SVN,6,6,0
2012,Germany,DEU,21,21,0
2015,Iceland,,0,0,0
2015,Finland,,0,0,0
2011,Nepal,NPL,1027,1027,0
2016,Anguilla,,0,0,0
2016,Ireland,,0,0,0
2022,Saint Vincent and the Grenadines,VCT,44,44,0
2016,France,FRA,19,19,0
2016,Costa Rica,CRI,0,0,0
2016,Australia,AUS,15,15,0
2022,Cyprus,CYP,0,0,0
2022,Grenada,GRD,24,24,0
2016,Cyprus,,0,0,0
2016,Botswana,BWA,17,17,0
2022,"China, Macao SAR",MAC,0,0,0
2022,Kiribati,,0,0,0
2022,Belize,BLZ,0,0,0
2022,Nauru,,0,0,0
2022,Norway,NOR,5,5,0
2022,Timor-Leste,TLS,0,0,0
2022,Seychelles,SYC,9,9,0
2016,New Zealand,NZL,8,8,0
2012,United Kingdom of Great Britain and Northern Ireland,GBR,28,28,0
2022,Samoa,,0,0,0
2013,Guatemala,GTM,72,72,0
2022,Barbados,BRB,15,15,0
2012,Cyprus,CYP,5,5,0
2016,Uruguay,URY,5,5,0
2022,Bahamas,,0,0,0
2022,Denmark,,0,0,0
2022,Iceland,,0,0,0
2022,Finland,,0,0,0
2022,Liechtenstein,LIE,5,5,0
2022,Marshall Islands,,0,0,0
2022,Vanuatu,VUT,0,0,0
2013,Tibetan,,0,0,0
2016,Portugal,PRT,10,10,0
2016,Vanuatu,,0,0,0
2016,Seychelles,SYC,0,0,0
2016,Turks and Caicos Islands,,0,0,0
2016,Marshall Islands,,0,0,0
2016,Liechtenstein,,0,0,0
2016,Luxembourg,,0,0,0
2016,Finland,,0,0,0
2016,Iceland,,0,0,0
2016,"China, Hong Kong SAR",HKG,0,0,0
2022,Estonia,EST,10,10,0
2016,Lesotho,LSO,0,0,0
2016,Sao Tome and Principe,STP,5,5,0
2016,Barbados,BRB,0,0,0
2016,Palau,,0,0,0
2016,Samoa,,0,0,0
2016,Timor-Leste,TLS,5,5,0
2016,Qatar,QAT,5,5,0
2016,Norway,NOR,10,10,0
2016,Nauru,,0,0,0
2016,Austria,,0,0,0
2016,Kiribati,,0,0,0
2016,Panama,PAN,0,0,0
2016,"China, Macao SAR",,0,0,0
2016,Suriname,SUR,0,0,0
2016,Antigua and Barbuda,,0,0,0
2013,Cyprus,CYP,5,5,0
2013,Botswana,BWA,11,11,0
2016,Switzerland,,0,0,0
2016,Sweden,SWE,5,5,0
2016,Slovenia,SVN,7,7,0
2017,Indonesia,IDN,61,61,0
2019,Nauru,,0,0,0
2015,Nauru,,0,0,0
2013,Marshall Islands,,0,0,0
2013,Luxembourg,,0,0,0
2013,Finland,,0,0,0
2017,Anguilla,,0,0,0
2017,Ireland,,0,0,0
2017,Vanuatu,,0,0,0
2017,Turks and Caicos Islands,,0,0,0
2017,Marshall Islands,,0,0,0
2017,Liechtenstein,,0,0,0
2017,Luxembourg,,0,0,0
2017,Finland,,0,0,0
2013,Iceland,,0,0,0
2017,"China, Hong Kong SAR",HKG,0,0,0
2017,Saint Kitts and Nevis,KNA,6,6,0
2017,Denmark,,0,0,0
2017,Bahamas,BHS,5,5,0
2013,Fiji,FJI,8,8,0
2017,Sao Tome and Principe,STP,5,5,0
2013,Solomon Islands,,0,0,0
2017,Palau,PLW,0,0,0
2017,Samoa,,0,0,0
2017,Seychelles,SYC,0,0,0
2017,Timor-Leste,TLS,5,5,0
2013,"China, Hong Kong SAR",,0,0,0
2015,Costa Rica,,0,0,0
2017,Nauru,,0,0,0
2017,Belize,BLZ,5,5,0
2015,Cabo Verde,CPV,27,27,0
2013,Liechtenstein,,0,0,0
2013,Turks and Caicos Islands,,0,0,0
2017,Panama,PAN,0,0,0
2013,Vanuatu,,0,0,0
2012,Portugal,PRT,10,10,0
2020,Marshall Islands,MHL,0,0,0
2020,Turks and Caicos Islands,TCA,0,0,0
2020,Vanuatu,,0,0,0
2020,Ireland,,0,0,0
2020,Anguilla,,0,0,0
2014,South Africa,ZAF,244,244,0
2011,Grenada,GRD,5,5,0
2011,Cabo Verde,CPV,22,22,0
2018,Israel,ISR,135,135,0
2011,Australia,AUS,33,33,0
2015,Uruguay,URY,5,5,0
2012,Finland,,0,0,0
2012,Luxembourg,,0,0,0
2015,Tibetan,,0,0,0
2012,Marshall Islands,,0,0,0
2012,Turks and Caicos Islands,,0,0,0
2011,Oman,OMN,47,47,0
2012,Vanuatu,,0,0,0
2012,Ireland,,0,0,0
2011,Maldives,MDV,10,10,0
2012,Anguilla,,0,0,0
2011,Cyprus,CYP,5,5,0
2014,Estonia,EST,25,25,0
2013,Anguilla,,0,0,0
2011,Spain,ESP,13,13,0
2013,Ireland,,0,0,0
2017,Kiribati,,0,0,0
2017,Lesotho,LSO,0,0,0
2015,Mozambique,MOZ,34,34,0
2015,Belize,,0,0,0
2015,Panama,PAN,0,0,0
2013,Bahamas,,0,0,0
2017,Mexico,MEX,71,71,0
2013,Lesotho,,0,0,0
2013,Sao Tome and Principe,,0,0,0
2015,Sweden,SWE,5,5,0
2013,Barbados,BRB,0,0,0
2015,Austria,,0,0,0
2017,Costa Rica,CRI,0,0,0
2017,Canada,CAN,33,33,0
2017,Madagascar,MDG,254,254,0
2015,Suriname,SUR,0,0,0
2015,Portugal,PRT,10,10,0
2013,Palau,PLW,0,0,0
2015,Qatar,QAT,5,5,0
2013,Saint Lucia,LCA,5,5,0
2013,Samoa,WSM,0,0,0
2017,New Zealand,NZL,8,8,0
2015,Kiribati,,0,0,0
2013,Saint Kitts and Nevis,,0,0,0
2017,Cyprus,,0,0,0
2017,Slovenia,SVN,7,7,0
2017,Switzerland,,0,0,0
2017,Antigua and Barbuda,ATG,0,0,0
2017,Suriname,SUR,0,0,0
2013,Denmark,,0,0,0
2015,Antigua and Barbuda,,0,0,0
2015,Switzerland,,0,0,0
2017,"China, Macao SAR",,0,0,0
2017,Guyana,GUY,32,32,0
2015,"China, Macao SAR",,0,0,0
2014,New Zealand,NZL,9,10,-1
2021,Spain,ESP,26,27,-1
2021,Fiji,FJI,8,9,-1
2012,Maldives,MDV,9,10,-1
2019,Japan,JPN,23,24,-1
2014,Mozambique,MOZ,34,35,-1
2015,Spain,ESP,19,20,-1
2018,Slovakia,SVK,206,207,-1
2016,Singapore,SGP,5,6,-1
2019,United Kingdom of Great Britain and Northern Ireland,GBR,26,27,-1
2011,Uruguay,URY,19,20,-1
2022,Oman,OMN,29,30,-1
2011,Ghana,GHA,5858,5859,-1
2021,New Zealand,NZL,7,8,-1
2014,France,FRA,14,15,-1
2015,Lithuania,LTU,43,44,-1
2020,Zambia,ZMB,130,131,-1
2013,Slovenia,SVN,11,12,-1
2013,Italy,ITA,22,23,-1
2018,Slovenia,SVN,6,7,-1
2015,Bolivia (Plurinational State of),BOL,162,163,-1
2017,Bulgaria,BGR,229,230,-1
2018,Belgium,BEL,5,6,-1
2020,Botswana,BWA,47,48,-1
2017,Fiji,FJI,8,9,-1
2018,Portugal,PRT,10,11,-1
2016,Germany,DEU,12,13,-1
2016,Haiti,HTI,3495,3496,-1
2018,Eswatini,SWZ,84,85,-1
2013,Zambia,ZMB,64,65,-1
2017,Spain,ESP,17,18,-1
2015,Singapore,SGP,6,7,-1
2018,Qatar,QAT,5,6,-1
2020,Mauritius,MUS,121,122,-1
2017,Lithuania,LTU,33,34,-1
2016,Spain,ESP,18,19,-1
2021,Portugal,PRT,11,12,-1
2020,Costa Rica,CRI,10,11,-1
2020,Canada,CAN,39,40,-1
2019,Latvia,LVA,45,46,-1
2021,Singapore,SGP,12,13,-1
2012,Belgium,BEL,36,37,-1
2022,Solomon Islands,SLB,5,6,-1
2012,Costa Rica,CRI,12,13,-1
2015,New Zealand,NZL,8,9,-1
2014,Argentina,ARG,24,26,-2
2015,Latvia,LVA,70,72,-2
2011,France,FRA,9,11,-2
2018,Solomon Islands,SLB,6,8,-2
2021,Dominica,DMA,32,34,-2
2015,Slovenia,SVN,7,9,-2
2012,Estonia,EST,115,117,-2
2019,Bulgaria,BGR,200,202,-2
2015,Belarus,BLR,2119,2121,-2
2012,France,FRA,7,9,-2
2015,Guatemala,GTM,78,80,-2
2017,Mozambique,MOZ,36,38,-2
2012,Kiribati,KIR,29,31,-2
2019,Estonia,EST,10,12,-2
2014,Slovenia,SVN,9,11,-2
2014,Lithuania,LTU,44,46,-2
2014,Bhutan,BTN,466,468,-2
2012,South Africa,ZAF,231,233,-2
2016,Rep. of Moldova,MDA,871,873,-2
2021,Grenada,GRD,24,26,-2
2017,Slovakia,SVK,207,209,-2
2018,Montenegro,MNE,574,576,-2
2019,Argentina,ARG,34,36,-2
2021,Eswatini,SWZ,83,85,-2
2022,Western Sahara,ESH,908,910,-2
2013,Singapore,SGP,7,9,-2
2013,Spain,ESP,17,20,-3
2011,Namibia,NAM,12,15,-3
2013,Haiti,HTI,3785,3788,-3
2013,Trinidad and Tobago,TTO,29,32,-3
2021,Greece,GRC,67,70,-3
2020,Saint Kitts and Nevis,KNA,5,8,-3
2012,Botswana,BWA,11,14,-3
2012,Peru,PER,579,582,-3
2012,Uganda,UGA,2286,2289,-3
2017,Equatorial Guinea,GNQ,100,103,-3
2017,Thailand,THA,74,77,-3
2015,Israel,ISR,121,124,-3
2018,Kenya,KEN,1054,1057,-3
2017,United States of America,USA,223,226,-3
2015,Netherlands (Kingdom of the),NLD,12,15,-3
2012,Japan,JPN,136,139,-3
2020,Bulgaria,BGR,196,200,-4
2018,Japan,JPN,24,28,-4
2020,Chile,CHL,306,310,-4
2011,Central African Rep.,CAF,654,658,-4
2011,Slovenia,SVN,10,14,-4
2022,United Arab Emirates,ARE,56,60,-4
2013,Nicaragua,NIC,16,20,-4
2013,New Zealand,NZL,10,14,-4
2022,Maldives,MDV,48,52,-4
2017,Bhutan,BTN,447,451,-4
2020,United Arab Emirates,ARE,73,77,-4
2013,Gabon,GAB,67,71,-4
2020,Greece,GRC,70,74,-4
2012,Jamaica,JAM,553,557,-4
2016,United Rep. of Tanzania,TZA,243,247,-4
2016,Viet Nam,VNM,11456,11461,-5
2020,South Sudan,SSD,554,559,-5
2021,Luxembourg,,0,5,-5
2021,Iceland,,0,5,-5
2021,Sao Tome and Principe,,0,5,-5
2015,Estonia,EST,20,25,-5
2012,Uruguay,URY,14,19,-5
2020,United Kingdom of Great Britain and Northern Ireland,GBR,21,26,-5
2017,Kenya,KEN,1057,1062,-5
2021,Germany,DEU,20,25,-5
2017,Australia,AUS,10,15,-5
2017,Cabo Verde,CPV,5,10,-5
2011,Philippines,PHL,298,303,-5
2020,Cabo Verde,CPV,5,10,-5
2012,Suriname,SUR,0,5,-5
2021,Costa Rica,CRI,5,10,-5
2013,Seychelles,,0,5,-5
2014,Costa Rica,CRI,0,5,-5
2013,Portugal,PRT,5,10,-5
2013,Switzerland,,0,5,-5
2020,Thailand,THA,77,82,-5
2015,Belgium,BEL,13,18,-5
2014,Jamaica,JAM,488,493,-5
2015,Bhutan,BTN,461,466,-5
2020,Belize,BLZ,0,5,-5
2022,Qatar,QAT,17,22,-5
2016,Denmark,,0,5,-5
2012,Switzerland,CHE,5,10,-5
2015,Cyprus,,0,5,-5
2017,Uruguay,URY,0,5,-5
2018,Nepal,NPL,717,722,-5
2021,Estonia,EST,10,15,-5
2018,Estonia,EST,12,17,-5
2013,Madagascar,MDG,262,267,-5
2020,Timor-Leste,TLS,0,5,-5
2019,Ecuador,ECU,99,105,-6
2016,Chile,CHL,338,344,-6
2014,Chile,CHL,330,336,-6
2021,Zambia,ZMB,124,130,-6
2013,Burkina Faso,BFA,753,759,-6
2021,Rep. of Korea,KOR,39,45,-6
2013,Germany,DEU,15,21,-6
2015,Germany,DEU,13,19,-6
2015,Australia,AUS,15,21,-6
2017,Rep. of Korea,KOR,63,69,-6
2015,Mexico,MEX,58,64,-6
2018,Bolivia (Plurinational State of),BOL,157,163,-6
2017,Chile,CHL,332,338,-6
2012,Ukraine,UKR,22027,22033,-6
2018,Germany,DEU,14,21,-7
2015,Brazil,BRA,132,139,-7
2020,Slovakia,SVK,183,190,-7
2015,Argentina,ARG,17,24,-7
2018,Lithuania,LTU,26,33,-7
2020,Eswatini,SWZ,85,92,-7
2013,Costa Rica,CRI,5,12,-7
2016,India,IND,1186,1193,-7
2020,Israel,ISR,115,122,-7
2021,France,FRA,21,28,-7
2022,Czechia,CZE,407,414,-7
2016,Estonia,EST,13,20,-7
2012,"China, Macao SAR",,0,8,-8
2013,Paraguay,PRY,5,13,-8
2014,Latvia,LVA,72,80,-8
2016,Belgium,BEL,5,13,-8
2013,Namibia,NAM,12,20,-8
2022,Fiji,,0,8,-8
2020,Rep. of Korea,KOR,45,53,-8
2020,Italy,ITA,35,44,-9
2019,Montenegro,MNE,565,574,-9
2021,Uzbekistan,UZB,1620,1629,-9
2013,Uruguay,URY,5,14,-9
2017,Japan,JPN,28,37,-9
2016,Latvia,LVA,61,70,-9
2016,Lithuania,LTU,34,43,-9
2013,Netherlands (Kingdom of the),NLD,14,23,-9
2014,Slovakia,SVK,255,264,-9
2011,Dominican Rep.,DOM,45,54,-9
2016,Bhutan,BTN,451,461,-10
2018,Norway,NOR,5,15,-10
2020,Equatorial Guinea,GNQ,110,120,-10
2019,Chile,CHL,310,320,-10
2019,Lithuania,LTU,16,26,-10
2020,Bahamas,,0,10,-10
2013,Austria,,0,10,-10
2013,Panama,,0,10,-10
2017,Bolivia (Plurinational State of),BOL,163,173,-10
2011,Hungary,HUN,300,310,-10
2017,Hungary,HUN,385,396,-11
2015,Slovakia,SVK,244,255,-11
2018,Ecuador,ECU,105,116,-11
2013,United Rep. of Tanzania,TZA,203,214,-11
2015,Indonesia,IDN,75,86,-11
2020,Dominican Rep.,DOM,130,141,-11
2016,Ecuador,ECU,112,123,-11
2011,Turkmenistan,TKM,388,400,-12
2015,Canada,CAN,28,40,-12
2013,Mexico,MEX,61,73,-12
2016,Peru,PER,416,428,-12
2022,Guinea-Bissau,GNB,1959,1971,-12
2018,Chile,CHL,320,332,-12
2019,Israel,ISR,122,135,-13
2014,Uzbekistan,UZB,2909,2922,-13
2020,Bolivia (Plurinational State of),BOL,154,167,-13
2020,Bahrain,BHR,304,317,-13
2013,Kiribati,KIR,16,29,-13
2021,United Arab Emirates,ARE,60,73,-13
2022,Mongolia,MNG,1690,1703,-13
2016,Indonesia,IDN,61,75,-14
2013,Dominican Rep.,DOM,36,50,-14
2012,Tunisia,TUN,1644,1658,-14
2016,Kyrgyzstan,KGZ,1391,1405,-14
2013,United Kingdom of Great Britain and Northern Ireland,GBR,14,28,-14
2013,Australia,AUS,21,36,-15
2016,Turkmenistan,TKM,187,202,-15
2011,Qatar,QAT,82,97,-15
2014,Hungary,HUN,398,413,-15
2020,Hungary,HUN,326,341,-15
2015,Ecuador,ECU,123,138,-15
2016,Equatorial Guinea,GNQ,103,119,-16
2014,United States of America,USA,269,285,-16
2012,Lithuania,LTU,303,319,-16
2013,Bolivia (Plurinational State of),BOL,143,159,-16
2011,Tibetan,,0,16,-16
2022,Slovakia,SVK,198,214,-16
2021,Bulgaria,BGR,180,196,-16
2013,Honduras,HND,74,90,-16
2016,Sierra Leone,SLE,2603,2619,-16
2011,Czechia,CZE,406,422,-16
2014,Equatorial Guinea,GNQ,136,152,-16
2014,Kiribati,,0,16,-16
2019,Slovakia,SVK,190,206,-16
2020,Mexico,MEX,89,105,-16
2020,Dem. People's Rep. of Korea,PRK,301,317,-16
2015,Equatorial Guinea,GNQ,119,136,-17
2022,Bhutan,BTN,257,274,-17
2018,Latvia,LVA,46,63,-17
2020,Madagascar,MDG,245,262,-17
2014,Peru,PER,422,439,-17
2011,Equatorial Guinea,GNQ,200,217,-17
2016,Cabo Verde,CPV,10,27,-17
2015,Thailand,THA,119,136,-17
2013,Malaysia,MYS,86,103,-17
2022,Ethiopia,ETH,19860,19877,-17
2012,United Rep. of Tanzania,TZA,214,231,-17
2013,Argentina,ARG,26,43,-17
2019,Romania,ROU,448,466,-18
2013,Belgium,BEL,18,36,-18
2013,Canada,CAN,40,58,-18
2020,Jamaica,JAM,669,687,-18
2021,Malawi,MWI,442,461,-19
2019,Bhutan,BTN,374,393,-19
2013,Venezuela (Bolivarian Republic of),VEN,95,114,-19
2017,Romania,ROU,572,591,-19
2015,Czechia,CZE,978,997,-19
2012,Bulgaria,BGR,389,409,-20
2018,Hungary,HUN,365,385,-20
2014,Algeria,DZA,2844,2864,-20
2011,Tajikistan,TJK,387,408,-21
2020,Czechia,CZE,740,761,-21
2020,Uganda,UGA,3322,3343,-21
2012,Hungary,HUN,279,300,-21
2019,Nepal,NPL,695,717,-22
2012,Israel,ISR,408,430,-22
2012,Equatorial Guinea,GNQ,178,200,-22
2012,Chile,CHL,576,598,-22
2015,Bulgaria,BGR,277,299,-22
2014,Madagascar,MDG,239,262,-23
2020,Romania,ROU,425,448,-23
2016,Belarus,BLR,2096,2119,-23
2019,Cuba,CUB,1708,1731,-23
2015,Sierra Leone,SLE,2619,2642,-23
2013,Japan,JPN,112,136,-24
2014,Bulgaria,BGR,299,323,-24
2016,Zambia,ZMB,102,126,-24
2015,Rep. of Moldova,MDA,873,897,-24
2016,Dem. People's Rep. of Korea,PRK,894,918,-24
2019,Hungary,HUN,341,365,-24
2022,Malawi,MWI,416,442,-26
2011,Jordan,JOR,1305,1331,-26
2021,Poland,POL,806,832,-26
2020,United Rep. of Tanzania,TZA,330,356,-26
2013,Equatorial Guinea,GNQ,152,178,-26
2014,Dem. Rep. of the Congo,COD,23026,23053,-27
2018,Bulgaria,BGR,202,229,-27
2020,Rwanda,RWA,4650,4677,-27
2018,Czechia,CZE,790,817,-27
2020,Angola,AGO,5918,5945,-27
2017,Poland,POL,970,998,-28
2014,Ecuador,ECU,138,166,-28
2012,Latvia,LVA,502,530,-28
2012,Bolivia (Plurinational State of),BOL,159,187,-28
2016,Rep. of Korea,KOR,69,97,-28
2022,"China, Hong Kong SAR",HKG,35,63,-28
2015,Philippines,PHL,92,121,-29
2013,Bhutan,BTN,468,497,-29
2019,Czechia,CZE,761,790,-29
2015,Comoros,COM,535,564,-29
2013,Bahrain,BHR,125,155,-30
2017,Kazakhstan,KAZ,1543,1574,-31
2013,Tajikistan,TJK,392,424,-32
2020,Ecuador,ECU,67,99,-32
2021,Bhutan,BTN,274,307,-33
2022,Tibetan,TIB,10,43,-33
2017,Czechia,CZE,817,852,-35
2016,Slovakia,SVK,209,244,-35
2018,Poland,POL,934,970,-36
2012,Croatia,HRV,62474,62510,-36
2021,Jamaica,JAM,632,669,-37
2020,Kazakhstan,KAZ,1512,1549,-37
2020,Congo,COG,5351,5388,-37
2012,North Macedonia,MKD,7292,7330,-38
2011,Bulgaria,BGR,409,448,-39
2015,Romania,ROU,953,992,-39
2016,Hungary,HUN,396,435,-39
2021,Dem. People's Rep. of Korea,PRK,262,301,-39
2011,Peru,PER,582,622,-40
2012,Slovakia,SVK,179,219,-40
2020,Poland,POL,832,873,-41
2016,Thailand,THA,77,119,-42
2022,Bahrain,BHR,201,244,-43
2015,United States of America,USA,225,269,-44
2011,India,IND,3713,3757,-44
2013,Oman,OMN,5,50,-45
2012,Azerbaijan,AZE,12613,12659,-46
2014,Poland,POL,996,1042,-46
2022,Dem. People's Rep. of Korea,PRK,215,262,-47
2016,Bulgaria,BGR,230,277,-47
2017,Nepal,NPL,722,770,-48
2017,Myanmar,MMR,3293,3341,-48
2012,Lao People's Dem. Rep.,LAO,7718,7767,-49
2018,Rep. of Moldova,MDA,769,818,-49
2012,India,IND,3663,3713,-50
2015,Somalia,SOM,93937,93987,-50
2019,Rep. of Korea,KOR,53,103,-50
2015,Kyrgyzstan,KGZ,1405,1457,-52
2017,Rep. of Moldova,MDA,818,871,-53
2018,Bhutan,BTN,393,447,-54
2011,Lao People's Dem. Rep.,LAO,7767,7821,-54
2012,Kenya,KEN,1278,1332,-54
2019,Belarus,BLR,1726,1784,-58
2020,Uzbekistan,UZB,1629,1687,-58
2021,Bahrain,BHR,244,304,-60
2013,Jamaica,JAM,493,553,-60
2019,Poland,POL,873,934,-61
2014,Azerbaijan,AZE,8100,8161,-61
2013,Rep. of Korea,KOR,143,205,-62
2014,Cameroon,CMR,3817,3880,-63
2022,Jamaica,JAM,569,632,-63
2016,Japan,JPN,37,101,-64
2012,Liberia,LBR,2909,2975,-66
2013,Bulgaria,BGR,323,389,-66
2020,Bhutan,BTN,307,374,-67
2017,Rwanda,RWA,4415,4484,-69
2018,Kazakhstan,KAZ,1474,1543,-69
2015,Rep. of Korea,KOR,97,168,-71
2015,Haiti,HTI,3496,3567,-71
2018,Togo,TGO,3698,3770,-72
2015,Georgia,GEO,5597,5669,-72
2020,Liberia,LBR,878,951,-73
2012,Albania,ALB,6286,6360,-74
2016,Liberia,LBR,1324,1398,-74
2017,North Macedonia,MKD,1468,1543,-75
2012,Ecuador,ECU,360,436,-76
2020,Philippines,PHL,157,233,-76
2011,Liberia,LBR,2975,3053,-78
2017,Colombia,COL,1582,1660,-78
2011,Rep. of Korea,KOR,157,236,-79
2014,Sierra Leone,SLE,2642,2722,-80
2020,Lao People's Dem. Rep.,LAO,6582,6662,-80
2015,India,IND,1193,1273,-80
2016,Poland,POL,998,1079,-81
2017,Burundi,BDI,1909,1991,-82
2013,Brazil,BRA,126,208,-82
2013,Uganda,UGA,2201,2286,-85
2020,Algeria,DZA,3712,3797,-85
2012,Cameroon,CMR,4645,4732,-87
2014,Rep. of Moldova,MDA,897,984,-87
2022,Togo,TGO,3607,3695,-88
2013,Estonia,EST,25,115,-90
2017,Belarus,BLR,2004,2096,-92
2012,Ethiopia,ETH,12854,12947,-93
2014,Togo,TGO,4712,4806,-94
2013,Mongolia,MNG,996,1091,-95
2015,Lao People's Dem. Rep.,LAO,7176,7272,-96
2019,Uzbekistan,UZB,1687,1785,-98
2013,Mozambique,MOZ,35,134,-99
2012,Togo,TGO,7302,7401,-99
2013,United States of America,USA,285,384,-99
2012,Poland,POL,1208,1309,-101
2013,Indonesia,IDN,75,180,-105
2018,Romania,ROU,466,572,-106
2018,Lao People's Dem. Rep.,LAO,6831,6938,-107
2022,Myanmar,MMR,2167,2274,-107
2016,Lao People's Dem. Rep.,LAO,7068,7176,-108
2020,Kyrgyzstan,KGZ,1184,1293,-109
2013,Qatar,,0,109,-109
2016,Kuwait,KWT,740,850,-110
2012,Czechia,CZE,291,406,-115
2016,Myanmar,MMR,3341,3456,-115
2020,Benin,BEN,451,566,-115
2015,Japan,JPN,101,216,-115
2016,Uzbekistan,UZB,2289,2406,-117
2013,Niger,NER,413,531,-118
2016,Nepal,NPL,770,890,-120
2020,Azerbaijan,AZE,8578,8700,-122
2014,Rwanda,RWA,4801,4926,-125
2016,Czechia,CZE,852,978,-126
2016,Congo,COG,5161,5287,-126
2011,Rep. of Moldova,MDA,5397,5524,-127
2017,Lao People's Dem. Rep.,LAO,6938,7068,-130
2020,India,IND,1562,1692,-130
2020,Montenegro,MNE,435,565,-130
2011,Kazakhstan,KAZ,2775,2906,-131
2020,Rep. of Moldova,MDA,658,790,-132
2016,Niger,NER,585,724,-139
2013,Peru,PER,439,579,-140
2022,Uganda,UGA,3230,3370,-140
2019,Kyrgyzstan,KGZ,1293,1433,-140
2011,Cambodia,KHM,13451,13595,-144
2013,Benin,BEN,175,320,-145
2020,Cambodia,KHM,11238,11387,-149
2013,Thailand,THA,128,280,-152
2011,Albania,ALB,6360,6512,-152
2016,Rwanda,RWA,4484,4638,-154
2020,Kenya,KEN,948,1104,-156
2022,Zimbabwe,ZWE,2224,2385,-161
2017,Angola,AGO,6028,6191,-163
2015,Rwanda,RWA,4638,4801,-163
2019,Myanmar,MMR,2863,3028,-165
2011,North Macedonia,MKD,7330,7495,-165
2020,Nepal,NPL,529,695,-166
2013,Poland,POL,1042,1208,-166
2018,Uzbekistan,UZB,1785,1953,-168
2019,Lao People's Dem. Rep.,LAO,6662,6831,-169
2018,Angola,AGO,5858,6028,-170
2015,Congo,COG,5287,5460,-173
2011,Congo,COG,6367,6541,-174
2015,Dem. People's Rep. of Korea,PRK,918,1092,-174
2020,Georgia,GEO,6511,6685,-174
2014,Colombia,COL,2233,2408,-175
2022,Lao People's Dem. Rep.,LAO,6522,6699,-177
2018,Cambodia,KHM,11570,11750,-180
2020,North Macedonia,MKD,1430,1610,-180
2019,Cambodia,KHM,11387,11570,-183
2015,Cambodia,KHM,12247,12431,-184
2016,Zimbabwe,ZWE,9286,9473,-187
2013,Romania,ROU,1203,1391,-188
2012,Cambodia,KHM,13260,13451,-191
2013,Cuba,CUB,1793,1985,-192
2013,Turkmenistan,TKM,197,390,-193
2020,Morocco,MAR,4134,4327,-193
2018,Cuba,CUB,1731,1924,-193
2013,Ecuador,ECU,166,360,-194
2020,Belarus,BLR,1529,1726,-197
2011,Tunisia,TUN,1658,1856,-198
2015,Armenia,ARM,8492,8692,-200
2022,Gambia,GMB,9323,9528,-205
2020,Niger,NER,992,1199,-207
2014,Romania,ROU,992,1203,-211
2017,Togo,TGO,3770,3981,-211
2013,Lao People's Dem. Rep.,LAO,7505,7718,-213
2020,Lebanon,LBN,3268,3486,-218
2014,Haiti,HTI,3567,3785,-218
2013,Philippines,PHL,113,332,-219
2018,Belarus,BLR,1784,2004,-220
2013,Yemen,YEM,1383,1605,-222
2011,Romania,ROU,1712,1934,-222
2013,Kuwait,KWT,731,954,-223
2017,Cambodia,KHM,11750,11974,-224
2020,Chad,TCD,2421,2650,-229
2014,Lao People's Dem. Rep.,LAO,7272,7505,-233
2016,Angola,AGO,6191,6427,-236
2017,Dem. People's Rep. of Korea,PRK,656,894,-238
2013,Nepal,NPL,864,1102,-238
2013,Chile,CHL,336,576,-240
2021,Myanmar,MMR,2274,2519,-245
2020,Sierra Leone,SLE,3053,3301,-248
2021,Zimbabwe,ZWE,2385,2636,-251
2013,Bangladesh,BGD,6257,6509,-252
2013,Lithuania,LTU,46,303,-257
2015,Togo,TGO,4451,4712,-261
2013,Cambodia,KHM,12996,13260,-264
2018,Myanmar,MMR,3028,3293,-265
2011,Algeria,DZA,5048,5314,-266
2016,Colombia,COL,1660,1928,-268
2022,Cambodia,KHM,11126,11397,-271
2016,Cambodia,KHM,11974,12247,-273
2022,Bosnia and Herzegovina,BIH,17796,18074,-278
2016,Burundi,BDI,1991,2276,-285
2013,Congo,COG,5756,6044,-288
2015,Liberia,LBR,1398,1687,-289
2022,Croatia,HRV,17511,17802,-291
2012,Algeria,DZA,4753,5048,-295
2014,Congo,COG,5460,5756,-296
2019,Croatia,HRV,23484,23781,-297
2015,Angola,AGO,6427,6727,-300
2013,Israel,ISR,108,408,-300
2012,Colombia,COL,2911,3214,-303
2015,Colombia,COL,1928,2233,-305
2011,Colombia,COL,3214,3523,-309
2015,Viet Nam,VNM,11461,11770,-309
2013,Kenya,KEN,959,1278,-319
2012,Romania,ROU,1391,1712,-321
2020,Togo,TGO,3389,3712,-323
2012,Congo,COG,6044,6367,-323
2018,Sri Lanka,LKA,41519,41844,-325
2011,Togo,TGO,7401,7727,-326
2021,Czechia,CZE,414,740,-326
2020,Croatia,HRV,23149,23484,-335
2017,Uzbekistan,UZB,1953,2289,-336
2017,Sri Lanka,LKA,41844,42180,-336
2012,Rep. of Moldova,MDA,5055,5397,-342
2020,Myanmar,MMR,2519,2863,-344
2021,Cuba,CUB,929,1284,-355
2013,Rwanda,RWA,4926,5284,-358
2013,Saudi Arabia,SAU,114,474,-360
2016,Romania,ROU,591,953,-362
2019,Bosnia and Herzegovina,BIH,16428,16792,-364
2015,Dem. Rep. of the Congo,COD,22658,23026,-368
2018,Dem. People's Rep. of Korea,PRK,287,656,-369
2011,Georgia,GEO,8760,9163,-403
2020,Armenia,ARM,8857,9277,-420
2017,Liberia,LBR,903,1324,-421
2013,Latvia,LVA,80,502,-422
2020,Cuba,CUB,1284,1708,-424
2017,Zimbabwe,ZWE,8852,9286,-434
2015,Zimbabwe,ZWE,9473,9909,-436
2020,Tunisia,TUN,1329,1765,-436
2020,Guinea-Bissau,GNB,1568,2024,-456
2020,Burkina Faso,BFA,1319,1775,-456
2016,Togo,TGO,3981,4451,-470
2017,Bosnia and Herzegovina,BIH,17523,18004,-481
2013,Liberia,LBR,2409,2909,-500
2013,Nigeria,NGA,9149,9652,-503
2013,Colombia,COL,2408,2911,-503
2015,Uzbekistan,UZB,2406,2909,-503
2018,Russian Federation,RUS,53999,54504,-505
2012,Dem. Rep. of the Congo,COD,26363,26871,-508
2013,United Arab Emirates,ARE,7,517,-510
2016,Bosnia and Herzegovina,BIH,18004,18518,-514
2014,Viet Nam,VNM,11770,12286,-516
2011,Rwanda,RWA,5827,6348,-521
2019,Sri Lanka,LKA,40996,41519,-523
2011,Dem. Rep. of the Congo,COD,26871,27400,-529
2015,Azerbaijan,AZE,7569,8100,-531
2012,Rwanda,RWA,5284,5827,-543
2013,Tunisia,TUN,1093,1644,-551
2020,Zimbabwe,ZWE,2636,3200,-564
2014,Cambodia,KHM,12431,12996,-565
2014,Angola,AGO,6727,7397,-670
2020,Sri Lanka,LKA,40312,40996,-684
2013,Jordan,JOR,662,1368,-706
2011,Sri Lanka,LKA,46226,46934,-708
2013,Sierra Leone,SLE,2722,3433,-711
2014,Liberia,LBR,1687,2409,-722
2018,Bosnia and Herzegovina,BIH,16792,17523,-731
2012,Georgia,GEO,8025,8760,-735
2013,Cameroon,CMR,3880,4645,-765
2012,Viet Nam,VNM,34978,35747,-769
2011,Burundi,BDI,5961,6733,-772
2011,Viet Nam,VNM,35747,36535,-788
2018,Serbia and Kosovo: S/RES/1244 (1999),SRB,30960,31751,-791
2018,Croatia,HRV,23781,24621,-840
2014,Zimbabwe,ZWE,9909,10749,-840
2014,Burundi,BDI,3297,4139,-842
2011,Lebanon,LBN,12969,13818,-849
2012,Burundi,BDI,5104,5961,-857
2022,Türkiye,TUR,77553,78415,-862
2019,Serbia and Kosovo: S/RES/1244 (1999),SRB,30062,30960,-898
2013,Burundi,BDI,4139,5104,-965
2020,Bosnia and Herzegovina,BIH,15461,16428,-967
2015,Burundi,BDI,2276,3297,-1021
2020,Serbia and Kosovo: S/RES/1244 (1999),SRB,28962,30062,-1100
2022,Pakistan,PAK,40423,41523,-1100
2013,Morocco,MAR,969,2074,-1105
2017,Russian Federation,RUS,54504,55612,-1108
2022,Serbia and Kosovo: S/RES/1244 (1999),SRB,29506,30738,-1232
2013,Kyrgyzstan,KGZ,1394,2646,-1252
2011,Angola,AGO,12476,13737,-1261
2022,Sri Lanka,LKA,48276,49565,-1289
2013,Iran (Islamic Rep. of),IRN,53591,54883,-1292
2012,Sri Lanka,LKA,44918,46226,-1308
2016,Serbia and Kosovo: S/RES/1244 (1999),SRB,35304,36634,-1330
2018,Zimbabwe,ZWE,7505,8852,-1347
2020,Egypt,EGY,7230,8613,-1383
2017,Croatia,HRV,24621,26013,-1392
2016,Türkiye,TUR,39634,41064,-1430
2011,Russian Federation,RUS,99767,101200,-1433
2013,Kazakhstan,KAZ,1380,2853,-1473
2013,Pakistan,PAK,14414,15894,-1480
2013,Albania,ALB,4755,6286,-1531
2012,Sierra Leone,SLE,3433,4987,-1554
2013,Libya,LBY,2572,4189,-1617
2013,Ethiopia,ETH,11224,12854,-1630
2019,Iran (Islamic Rep. of),IRN,100439,102120,-1681
2019,Somalia,SOM,109418,111104,-1686
2013,Belarus,BLR,2055,3801,-1746
2013,Algeria,DZA,2864,4753,-1889
2013,China,CHN,10934,12847,-1913
2013,Zimbabwe,ZWE,10749,12669,-1920
2020,Unknown,UNK,170039,171966,-1927
2020,Cote d'Ivoire,CIV,13293,15303,-2010
2013,Uzbekistan,UZB,2922,4959,-2037
2012,Angola,AGO,10392,12476,-2084
2014,Somalia,SOM,93987,96154,-2167
2013,Georgia,GEO,5647,8025,-2378
2022,Stateless,XXA,49720,52133,-2413
2015,Türkiye,TUR,41064,43483,-2419
2013,India,IND,1220,3663,-2443
2013,Togo,TGO,4806,7302,-2496
2012,Serbia and Kosovo: S/RES/1244 (1999),SRB,156385,158988,-2603
2014,Serbia and Kosovo: S/RES/1244 (1999),SRB,43489,46282,-2793
2013,Angola,AGO,7397,10392,-2995
2011,Sierra Leone,SLE,4987,8031,-3044
2015,Bosnia and Herzegovina,BIH,18518,21595,-3077
2012,Zimbabwe,ZWE,12669,15794,-3125
2013,Armenia,ARM,8385,11510,-3125
2015,Russian Federation,RUS,59076,62205,-3129
2014,Russian Federation,RUS,62205,65366,-3161
2011,Croatia,HRV,62510,65700,-3190
2019,Stateless,XXA,47318,50514,-3196
2014,Türkiye,TUR,43483,46727,-3244
2013,Dem. Rep. of the Congo,COD,23053,26363,-3310
2020,Ghana,GHA,4377,7712,-3335
2020,Senegal,SEN,7279,10637,-3358
2016,Russian Federation,RUS,55612,59076,-3464
2013,Montenegro,MNE,426,3943,-3517
2017,Serbia and Kosovo: S/RES/1244 (1999),SRB,31751,35304,-3553
2013,Ghana,GHA,2617,6188,-3571
2013,Rep. of Moldova,MDA,984,5055,-4071
2020,Bangladesh,BGD,14559,18678,-4119
2019,Zimbabwe,ZWE,3200,7505,-4305
2011,Bosnia and Herzegovina,BIH,58174,62553,-4379
2012,Türkiye,TUR,115138,119540,-4402
2020,Pakistan,PAK,38078,42483,-4405
2013,Azerbaijan,AZE,8161,12613,-4452
2011,Afghanistan,AFG,96698,101230,-4532
2011,Iraq,IRQ,147006,151641,-4635
2014,Bosnia and Herzegovina,BIH,21595,26461,-4866
2020,Nigeria,NGA,37056,42024,-4968
2020,Mali,MLI,16718,21771,-5053
2021,Croatia,HRV,17802,23149,-5347
2013,North Macedonia,MKD,1337,7292,-5955
2011,Türkiye,TUR,119540,125822,-6282
2022,Somalia,SOM,93226,99743,-6517
2015,Croatia,HRV,33290,39959,-6669
2012,Bosnia and Herzegovina,BIH,51465,58174,-6709
2015,Serbia and Kosovo: S/RES/1244 (1999),SRB,36634,43489,-6855
2013,Sri Lanka,LKA,37879,44918,-7039
2020,Gambia,GMB,9006,16183,-7177
2016,Croatia,HRV,26013,33290,-7277
2021,Ukraine,UKR,23301,30944,-7643
2020,Russian Federation,RUS,44785,54165,-9380
2013,Iraq,IRQ,126274,135786,-9512
2014,Croatia,HRV,39959,49606,-9647
2020,Somalia,SOM,98250,109418,-11168
2012,Iraq,IRQ,135786,147006,-11220
2013,Lebanon,LBN,1774,13066,-11292
2013,Croatia,HRV,49606,62474,-12868
2012,Unknown,UNK,107912,122533,-14621
2022,Eritrea,ERI,182659,198740,-16081
2022,Iran (Islamic Rep. of),IRN,93198,111461,-18263
2013,Unknown,UNK,88085,107912,-19827
2013,Ukraine,UKR,2097,22027,-19930
2011,Serbia and Kosovo: S/RES/1244 (1999),SRB,158988,180329,-21341
2013,Viet Nam,VNM,12286,34978,-22692
2011,Unknown,UNK,122533,145292,-22759
2020,Ukraine,UKR,30944,55657,-24713
2013,Bosnia and Herzegovina,BIH,26461,51465,-25004
2019,Iraq,IRQ,231297,260085,-28788
2019,Ukraine,UKR,55657,89283,-33626
2013,Russian Federation,RUS,65366,101016,-35650
2022,Iraq,IRQ,209892,250968,-41076
2018,Ukraine,UKR,89283,136306,-47023
2013,Türkiye,TUR,46727,115138,-68411
2016,Ukraine,UKR,236097,318338,-82241
2021,Unknown,UNK,80460,170039,-89579
2017,Ukraine,UKR,136306,236097,-99791
2013,Serbia and Kosovo: S/RES/1244 (1999),SRB,46282,156385,-110103
2022,Syrian Arab Rep.,SYR,4530612,4807122,-276510
